portuguese 9001	O André melhorou a Sanesul e os serviços prestados para a cidade”, explicou.
portuguese 9002	Já o Paraná Clube tem pela frente o Operário, na quarta-feira, na Vila Capanema.
portuguese 9003	O aluno teria que ter lido análises de obras”, disse.
portuguese 9004	Assim, seus filhos não poderão instalar programas novos sozinhos.
portuguese 9005	E não é com todo o mercado brasileiro, pois 80% do mercado brasileiro está tomado pelo filme americano.
portuguese 9006	A dona do empreendimento investiu em marketing em toda a cidade, promoção da logomarca com o telefone do serviço.
portuguese 9007	Depois, porque conseguiria trazer para a cidade milhares de pessoas que para ver um show de Beyoncé, de graça, não poupariam esforços.
portuguese 9008	Quando será a próxima?
portuguese 9009	!rs Lili, de Vancouver: 15 abril, 2009 as 7:29 pm Adorei saber que voce gosta do Tintin.
portuguese 9010	Roberto começa a desconfiar do vocabulário simples do amigo Manoel.
portuguese 9011	Seja a raça que for.
portuguese 9012	Purevbaatar diz que conhece um deles.
portuguese 9013	Mais cedo, o CGE havia colocado oito regiões em atenção, estado decretado quando a chuva tem potencial para provocar alagamentos.
portuguese 9014	Para isso, temos o Conselho Municipal de Meio Ambiente, já constituído.
portuguese 9015	O ELENCO da peça incluiu André Lara Resende, presidente do BNDES e, portanto, dono da sala grampeada.
portuguese 9016	Entre 17 e 19 não é possível retirar ilações da leitura do rácio preço-renda.
portuguese 9017	“Depois de mim e do Pelé, foi o melhor que vi jogar”, brincou.
portuguese 9018	Toda a polis, o tempo todo.
portuguese 9019	É pago aos dependentes do segurado durante todo o período de reclusão, contudo só poderá ser usufruído caso o segurado não esteja recebendo salário, auxílio-doença, aposentadoria ou abono de permanência em serviço.
portuguese 9020	Em vez de ficar escutando as bravatas da imprensa, os brasileiros deveriam todos desejar ser filhos de Erenice – para nunca mais terem medo do futuro.
portuguese 9021	"Se o PMDB renovar mesmo, pode ser que a gente fique.
portuguese 9022	Muitas pessoas que moram em prédios antigos, por exemplo, precisam deixar o carro na rua".
portuguese 9023	O objetivo era saber se é possível ou não ouvir ruídos mais altos vindos do prédio de onde caiu Isabella.
portuguese 9024	Na próxima segunda-feira (27) será publicada a segunda parte desta coluna, citando falhas que facilitam esse tipo de ataque e também quais as soluções para o problema.
portuguese 9025	Calcado nesta linha de pensamento, Ambrosim, que é educador, critica a forma como é conduzida a inclusão digital.
portuguese 9026	Quanto mais amparada emocionalmente, menor será a dor.
portuguese 9027	A melhor jogadora de futebol feminino do mundo foi contratada pelo Peixe por empréstimo até o fim da temporada.
portuguese 9028	Na educação temos superado os índices legais.
portuguese 9029	Este é mais um dos signos tradicionais. eu diria que o mais tradicional de todos eles, portanto, nada de roupas, coisas ou objetos exuberantes.
portuguese 9030	Não havia na cidade, qualquer placa ou posto informativo sobre o local do evento.
portuguese 9031	Prefeitos do Sul se reuniram no domingo, em Criciúma, para reabrir debate sobre a cobrança de pedágio em Palhoça, no trecho não duplicado da BR-101.
portuguese 9032	” Posted janeiro 24, 2011 at 1:45 PM A igreja é uma grande manipuladora voce mesmo é um manipulado, pra que padres e bispos papa e seu bando quer coisas em seus nomes?
portuguese 9033	Sob Dilma, coube aos ministros Guido Mantega (Fazenda) e Miriam Belchior (Planejamento) a missão de descer a faca.
portuguese 9034	Quando se mudou para o Texas, Wesley levava na bagagem a missão de reorganizar os negócios internacionais e imprimir-lhes o jeito JBS de ser.
portuguese 9035	Antes da caravana sair para percorrer a Figueira, Duarte Silva traçava já no rosto a feliz sensação de ter ganho a cadeira de Santana Lopes.
portuguese 9036	Na segunda-feira as delícias das férias e dos finais de semana de folga, darão lugar à correria alucinada em busca da grana que será usada para pagar a conta das férias e as despesas (IPVA, aluguel, faculdade, escola das crianças.
portuguese 9037	Dificuldades financeiras afetaram pelo menos dois dos eleitos.
portuguese 9038	As outras partes do livro passam-se numa área de serviço em Espanha, onde todos os personagens do romance comem e bebem numa grande conversa sobre o destino, sobre Portugal.
portuguese 9039	Segundo ele, era por volta de 17h de terça-feira, chovia muito, então decidiu deixar a piscina onde desfrutava da companhia da mulher e dos filhos.
portuguese 9040	Os trabalhos no cinema se multiplicaram rapidamente, formando um extenso ''currículo de peças não feitas'' por cerca de nove anos.
portuguese 9041	Aniversário com direito a selo (foto da direita) O jornal Expresso das Nove comemorou, na passada semana, o seu vigésimo aniversário.
portuguese 9042	As marcas da destruição ainda estão por toda parte.
portuguese 9043	Foram disponibilizadas mais oito motos, dois módulos móveis e oito viaturas de apoio tático para garantir a tranquilidade no eixo central, que recebe maior fluxo de pessoas nesta época do ano.
portuguese 9044	Na passarela, varais sustentavam fantasmas de outros vestidos – formas soltas no ar à espera de um material que nem precisa ser tão nobre assim para transformar o corpo humano: justamente o tecido.
portuguese 9045	Os defensores do "não" assumem o sofrimento das mães, criando muitas instituições para o aliviar, enquanto os do "sim" costumam escamotear a vida do embrião.
portuguese 9046	Mas o leitor deve estar se perguntando o porquê de repentina rebeldia de legislaturas tão mansas como têm sido as últimas no estado.
portuguese 9047	Ao longo da orla, diversos quiosques, alguns com música ao vivo.
portuguese 9048	Ao lado de Ulysses Guimarães, Tancredo Neves, Orestes Quércia e Marcos Freire, o gaúcho Paulo Brossard de Souza Pinto era uma das figuras mais admiradas pela oposição e temidas pelo governo.
portuguese 9049	De um lado fica a zona sul, onde vive a fatia mais rica da classe média.
portuguese 9050	"Recebemos uma informação do serviço de inteligência da PM e decidimos reforçar o policiamento", explicou.
portuguese 9051	A Austrália, que responde por 12% das exportações mundiais, viu seu volume de exportação ser reduzido em 24%, segundo dados atualizados daquele país.
portuguese 9052	Este exemplo traz apenas aplicações em embalagens.
portuguese 9053	Como é que um país com recursos limitados vai jogar neste tabuleiro?
portuguese 9054	Está lá, íntegro.
portuguese 9055	Talvez a crise se instale quando as interrogações existenciais sejam maiores que nossa capacidade de responder.
portuguese 9056	Vamos fazer uma campanha com responsabilidade.
portuguese 9057	Muito embora esta seja a previsão legal, todos nós sabemos que ela não é cumprida – daí o absurdo acúmulo de precatórios pendentes, apesar das facilidades de prazo (dez anos!
portuguese 9058	Chiquinho de Assis ganha força no Bahia O auxiliar e atual técnico interino, Chiquinho de Assis, depende “apenas” dos resultados e de uma conversa com PC Gusmão.
portuguese 9059	O procurador Afirma que, “na prática não foi o que aconteceu.
portuguese 9060	Joselito Vaca e Jhasmani Campos, que atuam no meio-de-campo da equipe, sofrem com problemas musculares, enquanto o volante Leonel Reyes já foi descartado por causa de uma lesão.
portuguese 9061	O que explica essa fragilidade da direita brasileira?
portuguese 9062	Decerto os pais da moça não aprovavam o namoro, mas os encontros se tornaram freqüentes.
portuguese 9063	Zaqueu descobre que é amado pessoalmente por Aquele que se apresenta como o Messias esperado, sente-se tocado no íntimo do seu espírito e abre o seu coração.
portuguese 9064	Para manter uma equipe profissional tem que trazer jogadores de fora, mas ter uma base ‘caseira’ é bem mais fácil”, analisa.
portuguese 9065	Maicon pergunta sobre o sócio de Carlito, mas o presidente do Nacional desconversa.
portuguese 9066	O Santos procurava aumentar ainda mais o placar, com o desafio de não deixar espaços na defesa.
portuguese 9067	Quem não votou é mandrião, o que está em linha com a baixa produtividade lusa!
portuguese 9068	Podem não ter votos suficientes para se elegerem, mas dinheiro deve ter de sobra.
portuguese 9069	“Fulano é assim”, portanto fulano é imutável e, portanto, fulano está morto, mas não sabe.
portuguese 9070	Segundo ela, ele é natural de Aracaju, Sergipe, e estaria mudando para outros estados, a fim de aplicar golpes diferentes.
portuguese 9071	Isso já está acontecendo na China.
portuguese 9072	Para o Dia das Mães do ano que vem, ele já está pensando em trazer um grande nome da música popular brasileira para cantar para todas as mães - vivas e as já falecidas.
portuguese 9073	O que é apresentado pelos exploradores atuais não passa de um "romance arqueológico", um "phony", gíria inglesa que significa uma invenção, uma "história pra boi dormir".
portuguese 9074	Quando vejo estas cenas fico muito triste e às vezes sinto que é por eles não saberem votar.
portuguese 9075	O jeito era ficar nos sonhos, na meditação (risos).
portuguese 9076	12 - Como é possível saber se alguém é hipersensível a sal?
portuguese 9077	Não tenho do que reclamar”, declara feliz.
portuguese 9078	Guillén-Nuñez, construiu também o quarto trecho da obra “mostrando” como é introduzida a arquitectura da igreja católica Romana na China.
portuguese 9079	Atualmente, Geraldo vive em uma cidade do litoral, é portador do vírus HIV e recebe uma aposentadoria por invalidez.
portuguese 9080	9. Passeie sensualmente - e sozinha Isso vai ajudá-la a melhorar seu próprio nível de sedução.
portuguese 9081	Afirmou que vai asfaltar toda a cidade, lembrando que faltam 16 bairros, resolver o problema da drenagem, para acabar com o empoçamento de água no período de chuvas, e que também fará a abertura de novas avenidas.
portuguese 9082	Bagunçado, o time tricolor rondou a área rival, mas Bobadilla não fez nenhuma defesa.
portuguese 9083	Essa era uma gente que viva no deserto em harmonia com as forças da natureza.
portuguese 9084	Assine nosso Newsletter Escrevo esta coluna e muita gente acha que só meto o pau, que só desejo o pior. Não, escrevo porque acho que estou sendo útil à comunidade. Gostaria de só escrever coisas boas, gostaria que não houvesse nada para criticar.
portuguese 9085	«Portanto, CondedeMenteTriste, pense por si, e seja racional!..
portuguese 9086	” (Jean-Jacques Rousseau) “Cada lágrima nos ensina uma verdade.
portuguese 9087	Foi a partir daí que o cangaceiro Lampião passou a exigir que o tratassem por Capitão Virgulino Ferreira.
portuguese 9088	Por ter falado a verdade.
portuguese 9089	Oscar Niemayer opinou sobre a obra, e julgou excelente o projeto estético integrado com o Dique do Tororó.
portuguese 9090	Até quando essa mesquinharia?
portuguese 9091	Ele tenta me dar raiva, mas não consegue.
portuguese 9092	A criança precisa de atenção amorosa.
portuguese 9093	O segundo tipo, no entanto, é responsável por dores mais intensas, que não passam com remédios comuns, e que merecem uma visita ao médico.
portuguese 9094	No quadrimestre foram habilitadas 6,8 milhões de linhas de celulares A Agência Nacional de Telecomunicações (Anatel) informou, na quinta-feira (20), que o aumento do número de..
portuguese 9095	A medida que a população vai crescendo e alguns hábitos irregulares continuam, o sobrepeso também vai aumentando.
portuguese 9096	Nas demais áreas do Tocantins, no sul de Rondônia e no leste do Pará, o sol brilha forte, a nebulosidade aumenta e chove de forma isolada a partir da tarde.
portuguese 9097	As palavras divinas precisam ser transmitidas por profetas, apóstolos etc. Depois interpretadas devidamente pelos sacerdotes das religiões.
portuguese 9098	Cada um dos 114 carros comprados pelo Metrô Rio na China custou US$ 1,296 milhão.
portuguese 9099	Brasiliense Ronald, não foi maldade não.
portuguese 9100	Um em cada seis habitantes da Terra não tem água potável para beber e dois em cada cinco não dispõem de acesso a saneamento básico.
portuguese 9101	O enquadramento à Categoria 1 é causa comum no município que não aceita a inclusão de Juína e região à Zona 3.3.
portuguese 9102	Raríssimas foram as vezes que em alguma cidade brasileira, as solenidades que marcam o dia 7 de setembro, o seu prefeito esteve ausente.
portuguese 9103	11.4 Caso ainda existam vagas ociosas, as mesmas serão preenchidas, por ordem de chegada dos candidatos, somente no dia 28 de agosto de 2010, das 8 ás 12 horas.
portuguese 9104	“Quem não se aperfeiçoa pessoal e profissionalmente vai ser deixado para traz pela concorrência.
portuguese 9105	É preciso fazer pesquisas e registos de um determinado edifício antes de o demolirem, mas claro que o Governo não faz nada.
portuguese 9106	Lúcia trabalha duro na prefeitura.
portuguese 9107	A grande porta de madeira escura se encontra fechada, mas uma gritaria que não se costuma ouvir numa igreja (ou talvez sim) aponta que o caminho é pelo lado, em direção aos fundos.
portuguese 9108	Diante dos dois candidatos, muitos eleitores têm vontade de anular o voto.
portuguese 9109	A Operação Sudoeste desenvolveu-se em vários municípios da região sudoeste do Paraná, em Jaraguá do Sul (SC), Ribeirão Preto e Assis (SP) e Brasília.
portuguese 9110	Estarei sempre ao seu lado o quanto posso.
portuguese 9111	Aos 18, Hernanes cobrou escanteio e Rodrigo Souto subiu entre os defensores para cabecear na trave.
portuguese 9112	Mexerá com alguma coisa.
portuguese 9113	Outra propaganda afirma que os efeitos do tênis na tonificação das pernas e dos glúteos "deixarão seus peitos com inveja".
portuguese 9114	Sera que nao existe uma mente humana que ve um comentario estupido e nao se sente ofendida?
portuguese 9115	Do tempo do Ari Pistola O vereador Bobi Bozzetti quer provocar uma grande reavaliação do Código de Posturas do município, que data de 1969.
portuguese 9116	Como rei eu tenho a obrigação de cuidar da população.
portuguese 9117	Uma vez diagnosticada a chateação, o jeito é mudar tudo na rotina que favorece o quadro nefasto.
portuguese 9118	Por fim, levantou a igrejinha de taboas com ajuda da população e no dia 24 de junho de 1934 a inauguração com uma missa rezada pelo Padre Mauro Eduardo de Valparaíso.
portuguese 9119	Quem tiver voto que siga em frente.
portuguese 9120	Foram 50 salas de alunos de 1º série, divididas em 22 escolas do município, entre ADI's, Emei's, Emef's e Emefei's.
portuguese 9121	Em tempo: aquele engenheiro chegou a ser, anos depois, vice-presidente da companhia.
portuguese 9122	Das 27 mil garrafas iniciais, a última safra (2004) se transformou em 47 mil e levou medalha de ouro em concursos na França.
portuguese 9123	O casal espera mais um bebê.
portuguese 9124	Infelizmente pode não ser moral, mas é legal.
portuguese 9125	A detecção foi feita com base numa nova técnica, que utiliza uma proteína modificada do HIV para localizar anticorpos específicos para a parte do vírus que se liga à célula infectada.
portuguese 9126	O Flamengo continuava a se aproveitar dos espaços deixados pelo Botafogo para encaixar contra-ataques.
portuguese 9127	Maria Rita Kehl é psicanalista Leia o texto no sítio do Estadão na web clicando aqui.
portuguese 9128	Massa, que largou em 21º, também ganhou posições na largada, mas na primeira parte da prova não conseguiu ser tão agressivo quanto Hamilton.
portuguese 9129	A consulta ao primeiro lote de restituições pode ser feita na página da Receita na internet (www.
portuguese 9130	E agora ela manda fotos só para ele.
portuguese 9131	O único a fugir deste roteiro foi Nonô Figueiredo, que errou no fim da reta oposta e ficou atravessado na pista.
portuguese 9132	Só falam em milhões e milhões.
portuguese 9133	Depois, contamos a nossos pais que iríamos recorrer aos avanços da medicina e que com isso eles logo teriam um neto.
portuguese 9134	Embora na França e parcialmente no Brasil, se tenha sentido a reação de um setor esclarecido e corajoso da sociedade, os atos concretos de protesta foram muito menos intensos que os da época dos anarquistas italianos.
portuguese 9135	Assemelha-se a uma cidade de passagem.
portuguese 9136	Se isso ocorrer será mais um vexame para o município,portanto o TRE deveria pensar bem no assunto.
portuguese 9137	Gary foi o segundo capitão do time de futebol americano da universidade nos anos de 1969, 1970 e 1971.
portuguese 9138	Neves - Explorando melhor as parcerias com a iniciativa privada.
portuguese 9139	Tem coisa na vida que é indefensável.
portuguese 9140	Com isso começou a beber freqüentemente.
portuguese 9141	Temos de ter cuidado para saber se o parecer do Tribunal não tem direcionamento político.
portuguese 9142	Na conquista, seu poder de sedução estará a mil. Relacionamento estável protegido.
portuguese 9143	Reforçou a imagem do candidato da união, contrapondo-se ao discurso da principal adversária, a pré-candidata do PT, Dilma Rousseff.
portuguese 9144	Bem, vamos a um resumo breve – se você não está entre os milhões de admiradores da saga pessoal de Elizabeth Gilbert.
portuguese 9145	O Homem não é só o seu corpo.
portuguese 9146	Se faltar um dos papéis, ou algum deles estiver incompleto, o recurso não pode sequer ser empenhado.
portuguese 9147	No último dia 8, dona Arlete Izabel da Silva completou um ano vivendo nas dependências do Hospital Estadual Azevedo Lima, no Fonseca.
portuguese 9148	A febre dos MMOGs explodiu primeiramente em países orientais, como Coréia do Sul e Japão, e depois avançou para os mercados europeu e dos Estados Unidos.
portuguese 9149	Já há reservas para casas simples em Itanháem, e cerca de 20% das casas disponíveis em Peruíbe já têm confirmação de locação para o Réveillon.
portuguese 9150	O Portal de Notícias da Globo Vídeos e fotos sobre o terremoto no Chile Tremor de 8,8 graus de magnitude atingiu o país em 27/02.
portuguese 9151	Ele estava na praça do bairro quando duas pessoas de aproximaram em uma motocicleta e efetuaram vários disparos.
portuguese 9152	O meia Everton tocou a bola, de carrinho, para Marcelinho Paraíba.
portuguese 9153	Ela é musicista desde os 4 anos, mas não resistiu aos apelos financeiros da indústria da moda.
portuguese 9154	Se eu tivesse que criticar alguém, não me esconderia atrás do anonimato”, disse ele, por celular.
portuguese 9155	Queria colocar Deus no laboratório da escola.
portuguese 9156	10) _____________________________________________________________________________ Estas Ementas foram selecionadas pelo advogado, mestre em Direito pela UFPR Gustavo Britta Scandelari.
portuguese 9157	Então é buscar eficiência nacional.
portuguese 9158	A promessa de Jaime Cezário, um dos carnavalescos da Mangueira, era fazer um desfile para emocionar o público.
portuguese 9159	No último mês, o Sport evoluiu.
portuguese 9160	No caso do Jaboticabal, a eleição foi anulada porque a maioria absoluta dos eleitores votou sem a apresentação de documento de identificação, o que é obrigatório.
portuguese 9161	Tudo só vai caminhar quando concluído o processo licitatório.
portuguese 9162	Não é uma miragem, é uma verdade!
portuguese 9163	Jamais fazemos alguma coisa antes, mesmo podendo.
portuguese 9164	Porém, as mulheres socialistas contactadas pelo DN reivindicam a José Sócrates uma maior presença feminina no próximo elenco governativo.
portuguese 9165	Neste chafariz há um painel contando a lenda da Mãe Preta.
portuguese 9166	Funcionária do TRT de São Paulo, ela foi cedida ao TST no mesmo dia em que tomou posse no cargo de motorista.
portuguese 9167	Leonardo Moura cruzour e Adriano ganhou a disputa com Adaílton para cabecear sem chances para o goleiro Felipe.
portuguese 9168	Ainda não se sabe quem está comandando o governo.
portuguese 9169	Localizado a 10 quilômetros de Santiago de Cuba, o preservado castelo do século 17 serve como síntese das contradições essenciais da cidade, a segunda maior do país, a 860 quilômetros de Havana, 14 horas de viagem de ônibus.
portuguese 9170	Parecia tudo diferente, com o médico Dr.
portuguese 9171	O “esforço de todos” tem, ainda assim, garantido a prestação dos melhores cuidados possíveis aos doentes, muito embora, alerta o médico, se esteja “no limite”.
portuguese 9172	Covas travou bate-bocas públicos com professores em greve.
portuguese 9173	Jonah se importava principalmente com comida (e ainda o faz), então eu ia até o mercado com uma lista e uma agenda, esperando usar aquela paixão para ensiná-lo conceitos essenciais.
portuguese 9174	É muito importante que as pessoas que vão às regiões de risco e os moradores desses locais ainda não imunizados recebam uma dose da vacina”, afirma a diretora de imunização da Secretaria.
portuguese 9175	Ela controla o nível das equipes/universidades por divisões.
portuguese 9176	Queria ser uma borboleta que é livre para voar por onde ela queira!
portuguese 9177	Essa liderança Lula conquistou apesar da mídia, e não por causa dela, como Dora Kramer sugere.
portuguese 9178	Fora desse setor não existia comercio, salvo as bodegas localizadas em algumas poucas ruas mais afastadas do centro da cidade.
portuguese 9179	É adquirida através do contato com sangue e outros fluídos corporais contaminados pelo vírus.
portuguese 9180	Se mudei de ideia relativamente ao que dizia, e digo, do governo Lula?
portuguese 9181	Onze horas, terminavam as aulas.
portuguese 9182	Coelho se baseia no fato de que o STJ foi genérico ao apreciar a matéria e não especificou quais serviços deveriam ser mantidos.
portuguese 9183	Sig sempre esteve entre eles.
portuguese 9184	Durante a reunião, Ruy Barbosa lembrou os governos tucanos em São Paulo e Minas Gerais e do peemedebista Paulo Hartung, no Espírito Santo, e deixou claro que o primeiro ano será de organização.
portuguese 9185	Eis uma lição tirada da catástrofe friburgense, que poderia ser propalada pelas diversas regiões do nosso Brasil e, talvez, por outros países do mundo!
portuguese 9186	Não quero antecipar isso.
portuguese 9187	Com gatos acontece a mesma coisa.
portuguese 9188	Tenho a legitimidade que me foi dada pela maioria do povo.
portuguese 9189	A confiança não é mais a pedra fundamental de nossa vida política.
portuguese 9190	Seria melhor alguém que não fosse ligado a crime nenhum, no lugar de João Beltrão.
portuguese 9191	Porque estou dando a oportunidade deles se defenderem..
portuguese 9192	Já estou com saudade do verão.
portuguese 9193	Melkisedek Donadon (PMDB-RR) - É ex-presidente da Assembleia Legislativa de Roraima.
portuguese 9194	Tem dinheiro para a saúde Ao longo dos últimos sete anos, a receita do Governo Federal cresceu duas vezes a arrecadação da CPMF.
portuguese 9195	Não sei, se se trata de uma armadilha, para algum garimpeiro.
portuguese 9196	O objetivo foi recolocar o Maranhão na lista dos principais roteiros turísticos do Brasil e do mundo.
portuguese 9197	E tem mais: a mentira, a hipocrisia, a pilantragem também contaminaram esta eleição de uma forma que não esperávamos.
portuguese 9198	Agora o senhor chega ao fim do mandato sob muitas críticas, inclusive de manter dentro da prefeitura pessoas ligadas aos Campos.
portuguese 9199	Enquanto não tiver resposta do pedido, cabe efetuar regularmente o recolhimento dos tributos.
portuguese 9200	O coronel Magno Silvestre, novo comandante interino da PM de Sergipe, ocupava atualmente a função de diretor-geral da Guarda Municipal de Aracaju.
portuguese 9201	O que se vê, na prática, são os direitos "dos manos".
portuguese 9202	Mas há ainda luta de camelos, empilhamento de copos e xadrez-boxe.
portuguese 9203	É prematuro apresentar uma calendarização das actividades.
portuguese 9204	O Governo presta contas perante a Assembleia da Republica.
portuguese 9205	Depois, disseram que a única reivindicação era um helicóptero para fugir.
portuguese 9206	Houve quem lucrou – e muito.
portuguese 9207	Ambos têm condições de criar e fomentar elementos e diretrizes para um bom projeto de Educação no País.
portuguese 9208	1580, alguem se lembrou de matar essa nação mas,não conseguiu.
portuguese 9209	Não existe limite de participantes, porém, para as convocações para assembleias, devem ser individuais e todos têm direito a voto, salários, gastos, cortes.
portuguese 9210	Cresci jogando na várzea desde cedo e me acostumei com isso.
portuguese 9211	As conversas sobre a partida existem desde 2009.
portuguese 9212	Segundo os dois vereadores está havendo uma resistência do eleitorado ao candidato de Damísio que está sendo considerado um “estrangeiro”.
portuguese 9213	"É muito difícil imaginar Dilma se oferecendo para solucionar um problema que até hoje ninguém conseguiu, como a paz no Oriente Médio", afirma Naím, referindo-se à tentativa de Lula de mediar uma solução para o conflito.
portuguese 9214	Conforme o uso - Colunas Assine Notisul no celular m.notisul.com.br Terça-feira, 12 de Abril de 2011 Tubarão, Santa Catarina Sol 24º 17º leorosa@matrix.
portuguese 9215	São Luiz ou São Luís do Maranhão?
portuguese 9216	Quanto à postura tática, considerando os treinos de preparação, é provável que o treinador modifique um pouco em relação ao último jogo, contemplando a entrada de um segundo atacante.
portuguese 9217	"Na realidade, ainda não sabemos em que dados o Ministério se baseou para incluir o Ceará na lista de emergência ambiental", observou.
portuguese 9218	Atualmente, na Arquidiocese de Lima, existem entre 40 e 50 locais em que a Exposição do Santíssimo Sacramento é permanente, com rodízios de adoração.
portuguese 9219	No início da minha carreira eu fazia o trabalho de DJ.
portuguese 9220	"Costumo dar atenção às pessoas com quem eu converso.
portuguese 9221	Kléber, ex-Santos, afirmou que se empenhará na disputa pela titularidade na lateral.
portuguese 9222	Esta afirmação é muito usada pelos pais ao filhos.
portuguese 9223	Numa conversa com o governador sobre o assunto, ele pediu para Zé Aldemir indicar um nome, para substituir Ricardo Barbosa, na Secretaria de Governo.
portuguese 9224	Nessa linha, o pedido legal para mudar o juramento é só um dos processos de que Newdow é autor.
portuguese 9225	Prefeito Clésio Salvaro, PSDB, fez questão de repassar para a Secretaria Regional parte da responsabilidade pela exclusão do Anel Viário do Orçamento do Estado para 2011.
portuguese 9226	E, nestas conversas muito além da escolha dos nomes e da lista do chá de bebê, descobri que a gravidez era difícil para algumas delas.
portuguese 9227	Para não deixar o partido sem candidato, eu posso ser".
portuguese 9228	Quem não sabe pode acabar acreditando que falo a verdade e que os meus adversários querem mesmo ‘dar’ as riquezas brasileiras para os gringos.
portuguese 9229	E o pior de tudo é que o cidadão tem o telhado igual a casa de vidro do BBB, e não aparece ninguém para jogar uma pedrinha sequer.
portuguese 9230	A INTERNET, que já mostrou força neste pleito explorando o “caso Rigo”, deve merecer mais atenção da classe política daqui pra frente.
portuguese 9231	O segundo mais votado também é filiado ao partido, Renato Casagrande, escolhido no Espírito Santo por 82,3% dos eleitores.
portuguese 9232	VENDE-SE Passat 81, gasolina, pintura nova, motor revisado, pneus bons.
portuguese 9233	O sistema realmente ficou paralisado, mas não por invasão de crackers.
portuguese 9234	Jogo muito intenso durante o primeiro quarto de hora com as duas equipas de olhos postos no ataque.
portuguese 9235	O então Juiz Eleitoral do município, Dr.
portuguese 9236	“Então é como se ele fosse o mais amado porque ele é filho dos dois, que ele vai ter mais privilégios, então é uma série de inseguranças que começam a acontecer aí.
portuguese 9237	O povo brasileiro senta e espera, por isso recebe bem o que merece: desprezo.
portuguese 9238	Jesualdo - As drags, ou transformistas, são um espetáculo.
portuguese 9239	Ubiratan & O que posso dizer é que, de um lado, somos gratificados.
portuguese 9240	Lá tem várias informações interessantes além das letras das músicas… OK!
portuguese 9241	Desde doenças mentais como depressão, ansiedade, psicoses e outras, até doenças somatizadas que atingem o corpo.
portuguese 9242	61. Casado com Izete Maria Pinto, dois filhos: Guilherme (13.
portuguese 9243	” Chico diz que ri para dentro.
portuguese 9244	A folha salarial é pequena, é verdade, porém, os contratos com terceiros são um canal de escoamento.
portuguese 9245	O sétimo lugar ficou com Elvis Presley e seu penteado no filme "Jailhouse rock".
portuguese 9246	Na tradição de sua cultura, eles precisam alcançar notas boas, para posteriormente optarem por cursos superiores promissores em termos de emprego, além de terem que ajudar nos estabelecimentos comerciais de seus pais no tempo livre.
portuguese 9247	63,2 milhões - usuários de internet no Oriente Médio.
portuguese 9248	Vários planetas mexem com a sua energia trazendo acontecimentos inesperados; às vezes ao seu gosto, às vezes não.
portuguese 9249	Nesses oito anos, o privilegiado paparazzo aprendeu muito sobre Michael Jackson.
portuguese 9250	Deixar as velhas mídias é um caminho inevitável.
portuguese 9251	Hoje é dia de Terçaneja na melhor casa noturna de todas as terças-feiras.
portuguese 9252	No dia 1º de julho de 1994, o Real entra efetivamente em vigor.
portuguese 9253	Foi a pessoa com quem conversava que falou isso, disse Amorim, com relação a essa informação publicada ontem na coluna.
portuguese 9254	"Impressionou-me ver as pessoas nas ruas festejando a morte de Pinochet", diz o escritor chileno Antonio Skármeta, embaixador do Chile na Alemanha no governo de Ricardo Lagos.
portuguese 9255	José Cid, um dos maiores talentos da música portuguesa, tem largas dezenas de canções que fazem parte do imaginário nacional, que vão do étnico ao fado, do pop ao rock, do popular ao jazz.
portuguese 9256	Após o discurso, Homero Pereira também foi procurado pelo diretor de Políticas Públicas da Ong Greepeace, Sérgio Leitão, para quem é possível fazer um trabalho conjunto entre a classe produtora e ambientalistas em favor da biodiversidade.
portuguese 9257	JV - Quem você poderia citar como um esportista que levou o nome do Brasil para o surf?
portuguese 9258	105. Alguns aspectos são tratados nos documentos já citados: A Escola Católica, 78-80; O leigo católico testemunha da fé na escola, especialmente 56-59, com indicações válidas não só para os professores leigos.
portuguese 9259	Atacaram todos os setores da administração e "pintaram" o peemedebista como um "gestor incompetente".
portuguese 9260	Santos acerta volta de Luxemburgo ao comando Santos (AE) - Houve uma reviravolta e Vanderlei Luxemburgo está de volta ao Santos, um ano e meio depois de ter saído para o Palmeiras.
portuguese 9261	As inscrições para o Vestibular 2011 da Unimep terminam no dia 1º de dezembro.
portuguese 9262	Após 30 anos de procura, Elisete e Augusto tiveram a idéia de ir até a Rádio Rainha das Quedas, que fez contato com a Rádio América.
portuguese 9263	Será uma ótima maneira de conhecer a si mesmos e evitar, no futuro, que se repitam inverdades que mancham a própria imagem.
portuguese 9264	Arcanjo, que era dono do Bingo Palácio, em Brasília, seria beneficiado pela medida.
portuguese 9265	Pelo Grupo C, o Standard Liege (da Bélgica) assumiu a liderança ao derrotar fora de casa o Partizan (da Sérvia), por 1 a 0, gol do brasileiro Igor, desconhecido no Brasil apesar de ser ídolo da torcida.
portuguese 9266	Será possível que esses atos covardes e insanos tenham que ser denunciados por um cidadão documentado com protocolo e tudo?
portuguese 9267	Em tempos de outroram, ROMA era império quandolá por aqueles lados decidiram então por o povo para governar.
portuguese 9268	Perdi cinco anos de trabalho científico por causa desse drama, mas ainda não é tarde demais para recuperá-lo.
portuguese 9269	Penso que tivemos alguma felicidade e considero o resultado justo.
portuguese 9270	Ousaram trabalhar - muito!
portuguese 9271	Atualmente no CSKA, da Rússia, Love animou a atividade do grupo e foi bem recebido pelo técnico Vanderlei Luxemburgo.
portuguese 9272	A churrasqueira também não parou um minuto sequer.
portuguese 9273	Acusado de envolvimento em esquema semelhante, Márcio Mansur foi preso pouco menos de um mês depois.
portuguese 9274	Otávio Neto se acostou aos votos de pesar apresentados, cobrou mais empenho na área da saúde, reclamou das estradas e cedeu o restante do seu tempo ao vereador Salomão.
portuguese 9275	Edison Carvalho disse: 31 de agosto de 2010 às 21:11 Parece que estamos diante da eminência do início da tão aguardada Reforma Política………, e melhor……, de maneira natural.
portuguese 9276	Há muito caminho para percorrer.
portuguese 9277	Quer um exemplo?
portuguese 9278	Para viagem levaram lingeries para ela e pijamas de seda para ele.
portuguese 9279	Assine o JORNAL DE FATO e ganhe sua senha para assistir esse maravilhoso espetáculo.
portuguese 9280	Por uma sinistra coincidência, os anúncios anteriores, de 2001 e 2002, foram feitos também em seguida a ondas de violência, que atingiram grandes proporções de divulgação na mídia.
portuguese 9281	Tem vacina, moço?
portuguese 9282	ÉPOCA – Você acha que o gênero franquia limita a criatividade?
portuguese 9283	Há livros que são “conhecidos”, outros que são “amigos comuns”, alguns “bons amigos” e poucos “grandes amigos”.
portuguese 9284	O dermatologista Walter Pinheiro comenta que o tratamento de fungos nas unhas é um dos mais longos na dermatologia.
portuguese 9285	O psicólogo, que esteve na cadeia por 11 anos, recebeu visita de médicos do Estado e independentes durante a greve de fome e já havia alertado que só iria ao hospital quando perder a consciência.
portuguese 9286	"É lógico que abala qualquer um quando tu tens razão e estás convicto disso.
portuguese 9287	Mas, para quem não fez o planejamento financeiro adequado,´dá para parcelar os débitos e quitá-los ao longo do ano.
portuguese 9288	É consagrada a Imaculada Conceição, tendo uma imagem de uns 60 cms de nossa senhora colocada sobre um ótimo altar de mármore.
portuguese 9289	Essa história da unificação dos títulos brasileiros cairia como luva no bestialógico de seu famoso "Febeapá" — o Festival de Besteira que Assola o País.
portuguese 9290	O acidente aconteceu no km 80 da RS-122 por volta das 19h.
portuguese 9291	Tudo começou em 1986, quando algumas crianças foram à casa de José lamentar que, naquele ano, não haveria, no bairro, a festa em homenagem a elas.
portuguese 9292	Hoje circulam cerca de 180 vans pela cidade.
portuguese 9293	O poder dos Estados Unidos está mais penetrado nos maiores países capitalistas do que em seu próprio país.
portuguese 9294	Não deveria mobilizar tanta gente!
portuguese 9295	“O custo para a sociedade é muito alto.
portuguese 9296	Os projetos do DAE somam R$ 103.0l6.
portuguese 9297	AG: O balanço, de acordo com os dados do Ministério da Justiça (MJ), pode dizer-se que é bom, apesar do Estado não ter facultado os meios dispostos na lei e haver alguma resitência inicial por parte dos outros operadores judiciários.
portuguese 9298	Agora, sob Silval, Cláudio conquistou espaço.
portuguese 9299	Os dois se desentendem e Ricardo chama Rodrigo de bastardo.
portuguese 9300	Fala também, entre os obstáculos, nas fusões e concentrações económicas, na instabilidade do mercado de trabalho, na pressão da publicidade e na luta pelas audiências.
portuguese 9301	Não será simples ferver uma gota de água, arejá-la, filtrá-la?
portuguese 9302	Forbes - Todos os países enfrentam dificuldades.
portuguese 9303	Elys Chargel, psicóloga de 41 anos, trabalha no grupo Mulheres Que Amam Demais Anônimas (Mada), do Rio.
portuguese 9304	Além disso, o padre Jeferson foi desrespeitado, enfiado num camburão da polícia, e ouviu piadas sobre seus trajes litúrgicos.
portuguese 9305	"é como ir ao médico..
portuguese 9306	No evento, o sub-secretário executivo Fernando Willian apresentou um estudo sobre recursos e prazos para a redução das deficiências habitacionais de todo o Estado do Rio de Janeiro, município a município.
portuguese 9307	Urbanitários denunciam dívida da PMB com Cosanpa Servidores municipais de diversos órgãos municipais e os membros do Sindicato dos Urbanitários se pr..
portuguese 9308	A indicação de um tratamento de rejuvenescimento deixará de ser subjetivo, às vezes encarado como futilidade, para tornar-se algo objetivo - diz.
portuguese 9309	"Nosso desafio foi criar um carro com atributos que ofereçam uma aparência mais robusta do que seus principais concorrentes e transmita muito prestígio aos seus proprietários.
portuguese 9310	6. Já viu algum defensor dos direitos humanos defendendo esta bolsa para os filhos das vítimas?
portuguese 9311	A maioria das evidências mostra que a radiação dos celulares tem pequeno impacto biológico.
portuguese 9312	Segundo conta a coordenadora do Caispede, Marise Gaspari, Bento Gonçalves foi a segunda cidade a implantar a coordenadoria.
portuguese 9313	ANTERIORES As bandas de pífanos de Caruaru gravam discos, animam festas juninas e lutam pela sobrevivência Sérgio Adeodato, de Caruaru O instrumento, um pedaço de bambu semelhante a uma flauta, foi inventado há séculos pelos índios.
portuguese 9314	Mas que seja em nome do progresso.
portuguese 9315	TRABALHADORES - Na quarta-feira, os guardas civis Campos e Urbano passaram defronte um matagal no Conjunto Habitacional dos Trabalhadores e depararam com um individuo retirando algo do solo.
portuguese 9316	Débora afirma que gosta de conhecer pessoas novas e olha fixamente para Vicente.
portuguese 9317	Boa noite Sadan: Nesta sexta feira, estavam recolhidos na cadeia publica de Amparo, 9 (nove) adolescentes de Bragança e Região.
portuguese 9318	As faltas devem ser reparadas por quem as causou, não concordamos que seja humilhação pagar pelo que se faz.
portuguese 9319	Nossa previsão era de que esse volume só fosse atingido em 2007”, afirma.
portuguese 9320	Mais do que isso, os imigrantes do Swat dizem que estão com a sensação de que quanto mais tentam ajudar suas famílias em casa, mais dano podem causar, um dilema terrível que os enche com uma combinação de impotência, medo, tristeza e culpa.
portuguese 9321	Onde o Galo quer chegar?
portuguese 9322	A música é uma arma..
portuguese 9323	Fiocruz vai estudar motivos da opção por parto normal ou cesariana Uma equipe de pesquisadores da Escola Nacional de Saúde Pública (Enasp), ligada à Fundação Oswaldo Cruz (Fiocruz),..
portuguese 9324	Além de estarmos mantendo o terreno limpo, estaríamos dando um visual diferente do lote dentro da área urbana do município”, explicou.
portuguese 9325	Uma como diversão e outra para leva uma amiga para dar conselhos ao seu filho.
portuguese 9326	Antonio deu a seguinte entrevista a ÉPOCA.
portuguese 9327	“Eu sabia que mais cedo ou mais tarde ele voltaria ao lar”, disse sorridente.
portuguese 9328	Terá uma confidente a altura.
portuguese 9329	Este ano, Ilhas Cayman, Colômbia, Gana, Montenegro, Paquistão, Peru e Sérvia fazem a estreia no evento.
portuguese 9330	Em Perdida na Floresta a narrativa parte de uma grande perda familiar.
portuguese 9331	O Rio do Sono forma a Cachoeira do Cocal, outro espetáculo da natureza, próximo à praia.
portuguese 9332	Agora, convém recordar e sublinhar que estas são verbas destinadas exclusivamente ao lixo.
portuguese 9333	O técnico do Beira-Mar lembrou, ainda, o valor do Marítimo.
portuguese 9334	Além da pasta, o partido quer mais um ministério.
portuguese 9335	Sempre com um sorriso no rosto, a gente fica feliz só de olhar para ela.
portuguese 9336	“Fica realmente tudo muito mixado”, confirma Moacir Dalla Palma, o alto.
portuguese 9337	O lema principal dessa classe que cresce assustadoramente em nosso meio, é fomentar brigas para aumentar as intrigas, pois ela sabe que distribuindo indiferenças, pode passar no meio de todos zombando da miséria dos outros.
portuguese 9338	Os dois são naturais do Ceará e possivelmente sejam alunos ou já formados no curso de enfermagem.
portuguese 9339	As 11 pessoas faziam o "roço de juquira" (preparação do pasto para a criação extensiva de gado), além de montar cercas, operar motosserras para o desmatamento e exercer a função de boiadeiros.
portuguese 9340	Olha o Maria da Fonte!
portuguese 9341	Passada a fase de crise mundial, que fez com que no Natal passado as vendas despencassem, muitas lojas investiram no aumento de seus estoques, pensando em vender muito e oferecer um maior número de produtos ao exigente cliente da cidade.
portuguese 9342	Trata-se da opinião de um perito, de um especialista, não só dele mas de outros que acompanharam e estiveram envolvidos no caso.
portuguese 9343	Dizemos que as mulheres reclamam demais.
portuguese 9344	“O problema será quando eu encontrar do outro lado com um motorista daltônico.
portuguese 9345	VENDE-SE: Barbada terreno na rua asfaltada 14x30min, no bairro Coqueiros, rua Acacilia Capelão Peres, terreno de esquina, alto e seco.
portuguese 9346	O apresentador do programa Gazeta Alerta, jornalista Edvaldo Sousa ligou para negar que disputará uma vaga de deputado federal pelo PMDB, mas, admitiu que será candidato a uma vaga na Aleac pelo PSDC, para não deixar o "cavalo passar selado".
portuguese 9347	O Milan pede os R$ 18,4 milhões e venderia também parte dos direitos do atleta na negociação.
portuguese 9348	Apesar das saídas de Jéfferson e Élton (contratados pelo Vasco), Sérgio Guedes ainda conta com opções interessantes, como os experientes Rodrigo Fabri e Élvis.
portuguese 9349	Como bom artilheiro, tem tudo para fazer o gol.
portuguese 9350	A de ontem era um prato cheio e foi comentário nas melhores rodas da cidade.
portuguese 9351	Conforme as normas de regência acima transcritas, sujeitam-se à penalidade de multa pela ocorrência de propaganda eleitoral antecipada tanto o responsável por sua divulgação quanto o beneficiário, quando comprovado seu prévio conhecimento.
portuguese 9352	Nadir enfatiza que o trabalho da Apae é buscar qualificação para os alunos, além de aprimorar as relações pessoais, por meio de um conjunto de ações para resultados reais, que se somem para a entrada no mercado de trabalho.
portuguese 9353	Logo a seguir foi a vez de Ruben, para o Maximinense, desperdiçar nova oportunidade.
portuguese 9354	Acho que o André não deveria perder a eleição em Dourados.
portuguese 9355	Você é uma professora comprometida com a sociedade e merece tudo de bom.
portuguese 9356	O que foi feito antes preparou melhor a AP para este desafio.
portuguese 9357	O que é uma informação sobre a qual não há nenhum controle?
portuguese 9358	Pode acontecer do PSD compor a base do governo em 2012, fazendo uma composição com partidos de centro-esquerda?
portuguese 9359	Nos Estados Unidos, como um todo, o desemprego subiu de 7% para 10%.
portuguese 9360	Alguma coisa tem que ser mudada na estrutura para que realmente possa se combater a violência no seu ponto de origem.
portuguese 9361	Imagina com que cara eu vou aparecer no jantar de gala que o capitão está oferecendo?
portuguese 9362	Confiamos cem por cento na ideia de que ele não quis interferir em assuntos internos do Irã.
portuguese 9363	Se as crianças e jovens não necessitassem de educação e de transmissão de valores também na escola então a educação seria apenas algo académico e poderiam enquanto crianças tomarem decisões sobre todos os temas.
portuguese 9364	Por outro lado, produziria um insignificante sucesso de ocasião que a mim não interessa, mas interessa ao PFL do prefeito.
portuguese 9365	Ele comentou também que o governador Confúcio Moura (PMDB) defendeu a nomeação de fichas-limas em seu Governo.
portuguese 9366	O mesmo percentual (7,5%) é aplicado no serviço de esgoto e no preço público da água bruta consumida pelas empresas.
portuguese 9367	Os números já foram apresentados.
portuguese 9368	No local haverá ainda uma feira de negócios, com empresas oferecendo seus produtos e serviços.
portuguese 9369	Certo é que as acções do Governo acabam por dar consistência às aparições.
portuguese 9370	Dentro de casa nunca ví nada, mas os vizinhos comentavam que andava em más companhias e estava envolvido com traficantes - lamentou o pai.
portuguese 9371	Pode ser até a própria.
portuguese 9372	A intervenção ocorreu numa sessão de formação promovida no Cefojor, enquadrada na celebração anual de 3 de Maio, dia mundial da liberdade de imprensa.
portuguese 9373	“As cenas foram veiculadasem horário impróprio e depois a Globo ainda reprisou noprograma da Ana Maria Braga.
portuguese 9374	Algumas provas são irrefutáveis, condenando-os por antecipação.
portuguese 9375	Acredito que externaram seus preconceitos porque julgaram estar entre pares.
portuguese 9376	O centroavante Keirrison foi o salvador do Palmeiras.
portuguese 9377	A carreira política teve início em 1999, quando assumiu a presidência do PTB do município e, em 2000 e 2004, foi candidato a prefeito de Paraíso.
portuguese 9378	TVCA - O senhor se arrepende de ter se relacionado com a adolescente?
portuguese 9379	Mas quer trabalhar.
portuguese 9380	Por acaso são regras que fogem e as levam em direção ao satanás?
portuguese 9381	O ex-governador Geraldo Alckmin, candidato ao governo paulista pelo PSDB participa do programa com um depoimento de apoio aos candidatos.
portuguese 9382	Moura concorreu ao cargo de deputado federal pela mesma coligação proporcional que Valtenir.
portuguese 9383	A sobra ficou com Messi, que levantou na cabeça de Tevez.
portuguese 9384	O “bate-boca” continuou com outro ministro – Santos Silva – a contrariar os dois: “o que é preciso é estabilidade”!
portuguese 9385	7-Os portugueses ja deveriam resolver o problema das suas colonias, afinal mesmo na uniao europeia existem excepçoes para aquilo que lhes interssa.
portuguese 9386	Várias comissões foram criadas exatamente para dar condições aos excluídos do sistema.
portuguese 9387	Obrigado a todos que participaram e aguardem que, em breve, teremos novas promoções.
portuguese 9388	“O SINE entra em contato com várias empresas e faz um levantamento da demanda de mão-de-obra.
portuguese 9389	No serviço público a imagem que o funcionalismo público tem do Cargo de Confiança é que se trata de um politiqueiro oportunista e incompetente, atrás de uma tetinha.
portuguese 9390	Sei que não sou nenhum galã”.
portuguese 9391	Naquela oportunidade ouvi em alto bom som, o deputado estadual João Beltrão dizer que o governador de Alagoas, Teotonio Vilela Filho era uma grande preguiçoso que acordava às14 horas para ir ao Palácio República dos Palmares.
portuguese 9392	Uma boa regra da qual não se exige o respeito não é sequer uma regra, é apenas um desejo bem intencionado.
portuguese 9393	O nome do PT é José Pimentel, ministro da Previdência.
portuguese 9394	Após a missa os fiéis poderão contar com a animação do cantor Romão.
portuguese 9395	As italianas Lotto e Kappa têm interesse em vestir o Palmeiras.
portuguese 9396	Tem como a pessoa gostar de esporte sem ter tido paixão por um time?
portuguese 9397	A convenção do próximo dia 24 é estratégica, já que serão definidos, além dos membros do diretório municipal, os delegados de Curitiba que votarão para definir se o partido terá ou não candidato próprio ao governo.
portuguese 9398	De vez em quando ele dá uma dentro, especialmente quando os interesses pessoais o libertam para pensar politicamente.
portuguese 9399	Algumas conquistas importantes do passado foram abandonadas..
portuguese 9400	Da forma como foi colocada, não afeta a cidade e também não aumenta a duração do muro, pelo contrário", defende-se Luiz Roberto Sniecikovski, filho de Sylvio.
portuguese 9401	Charretes, muitos cactos, panelões no fogo com ensopados, batata doce, carne de sol, aipim, espetinhos, baião de dois, tudo "light".
portuguese 9402	A próxima será vista na quarta-feira, quando os petistas vão reunir blogueiros e tuiteiros apoiadores dos candidatos do partido.
portuguese 9403	Auxiliar de comércio exterior - Salvador Exige: sexo masc., 3º grau inc.
portuguese 9404	Impossível não se lembrar daquele episódio em que o Pateta tem dupla personalidade e se transforma num monstro quando assume o volante.
portuguese 9405	Faz muita diferença para nós.
portuguese 9406	Acreditem: Depois de longa espera, foi patrolada somente uma parte da rua!
portuguese 9407	Afinal, na abertura dos Jogos Panamericanos as vaias ao presidente Lula foi resultado de uma traquinagem orquestrada por asseclas do prefeito César Maia que, naturalmente, negou sua responsabilidade no episódio.
portuguese 9408	Muitos analistas, porém, acham que Washington exagera a influência que Pequim tem sobre Pyongyang, bem como a disposição do regime chinês em usar tal influência.
portuguese 9409	Graças ao meu pai, Leão se tornaria um grande conhecedor de madeira.
portuguese 9410	A cidade já tinha 13 detentos e agora está com 28, somando os de Areia Branca.
portuguese 9411	Muitas pessoas levam a música como passatempo, mas ela, inevitavelmente, era o que eu queria para o resto da minha vida.
portuguese 9412	Um policial em fim de carreira eprofundamente melancólico com sua impotência diante da“tempestade" que se avizinha, a saber, um temporal de violênciagratuita e da mais completa desconsideração pela vidahumana.
portuguese 9413	Não se esqueça do ditado: diga-me com quem andas, que direis que tu és.
portuguese 9414	Eles passam a receber o reajuste já concedido em 2007 para outras regiões do País, que varia R$ 1.460,00 a R$ 9.000,00, dependendo do porte do município.
portuguese 9415	CLAUDIO - Curto e Grosso: 4 outubro, 2009 as 10:45 am Interessante, nunca tinha lido qualquer texto de Paulo Coelho mas hoje, tenho a impressão de já te-los lido em tempos atraz.
portuguese 9416	"Só no mês de agosto, três mil pernoites deixarão de ocorrer", diz.
portuguese 9417	11.09) América Latina - Natal sedia I Seminário Latino-Americano de Comércio Justo e Economia Solidária (17.
portuguese 9418	O PT foi construído a partir das discussões com a base.
portuguese 9419	Depois disto é preciso traçar metas para reduzir despesas.
portuguese 9420	Mais tenho direito a opinião.
portuguese 9421	Daniella comenta que a maioria dos clientes prioriza descobrir o autor responsável pelos atos, e questões como indenização tornam-se pouco relevantes quando o objetivo de saber a autoria é atingido.
portuguese 9422	Divertida porque o pessoal do "Cansei", sendo notoriamente uma extração de ricos e gente de classe média, detesta ser apontado como rico e gente de classe média.
portuguese 9423	Vamos ficar de olho, se esse deputado vai ou não se instalar em nossa cidade.
portuguese 9424	Até nos professores.
portuguese 9425	Podemos imaginar que em 2020 terapias celulares serão usadas para tratar diabetes, alguns tipos de cegueira, infarto e derrame STEVENS REHEN, presidente da Sociedade Brasileira de Neurociências e Comportamento A primeira delas é de ordem política.
portuguese 9426	Para ele, o salário mínimo de R$ 545 é um "avanço importante".
portuguese 9427	Sergio - 39 - Analista de sistema Não conheço e nem quero ter o desprazer de conhecer esse Sr. que ainda consegue se intitular PADRE.
portuguese 9428	Queria cumprimentar o prefeito (de Sumaré) José Antonio Bacchim.
portuguese 9429	É impossível não associar a propaganda televisiva de Micarla de Souza, candidata do Partido Verde, líder nas pesquisas para a Prefeitura de Natal, com a do democrata Barack Obama, candidato à Presidência dos Estados Unidos.
portuguese 9430	Os petistas se desculparam e não tiveram coragem de mostrá-la à imprensa alegando de que se tratava de material interno.
portuguese 9431	Onde anda a auto estima de vocês?
portuguese 9432	Bom que se diga que o 'Sensei João Paulo' é completo em educação física, e, a garotada gosta da disciplina com que conduz a prática esportiva.
portuguese 9433	Tenho fixação por música!
portuguese 9434	Depois vc diz que se surpreendeu a 8 anos com o slogan da marca da era Lula “Brasil, um país de todos”, eu realmente não entendo o porquê.
portuguese 9435	Mas, apesar de Madonna ter irritado os russos em sua última passagem por Moscou, o governo do Cazaquistão não tolera mesmo as críticas que o personagem faz ao país.
portuguese 9436	Haveria um aumento do consumo?
portuguese 9437	Os mensaleiros que Edmar protegeu, quando fazia parte do Conselho de Ética, não sobreviveram?
portuguese 9438	Na ocasião, a CPI dos Correios investigava o mensalão, um esquema de repasse de R$ 55,8 milhões pelo PT a deputados de partidos aliados em troca de apoio no Congresso.
portuguese 9439	Não gosto disso, não'”, conta ela, às gargalhadas.
portuguese 9440	A primeira etapa já tem reservados R$ 450 milhões.
portuguese 9441	Ao fim de um ano e meio de treinamento, ela investiu os recursos na aquisição de duas máquinas de costura e uma de bordado.
portuguese 9442	E Deus disse-lhe: - Quando eu criei a mulher, tinha de fazer algo muito especial.
portuguese 9443	Foi criado o PROUNI, ENEN, dando mais oportunidade as classes operariadas, como foram criadas várias universidades.
portuguese 9444	O Sr. está no rumo certo, estou gostando da sua administração.
portuguese 9445	Mas pode vir aí a "segunda chance"!
portuguese 9446	Em embalagem caprichada, os saquinhos traziam a receita do sabão.
portuguese 9447	O pró­xi­mo com­pro­mis­so do Al­vi­ne­gro pelo Es­ta­dual está mar­ca­do para o dia 10 de março, con­tra o Ale­crim, no es­tá­dio Fras­quei­rão.
portuguese 9448	A apuração mostra, nesta segunda-feira, que os candidatos da oposição obtiveram mais de um terço das cadeiras da Assembleia Nacional, acabando com a maioria absoluta da situação no Legislativo, informa o Wall Street Journal.
portuguese 9449	A taxa de juro é um nó que o governo terá de desatar.
portuguese 9450	“Estou muito feliz por Novo Horizonte ficar entre os melhores do País.
portuguese 9451	Ele me falou que uma cobra chegou a permanecer parada ao seu lado por algumas horas.
portuguese 9452	Incluímos no PAC 2 a bacia do Burati, e os projetos executivos também já foram aprovados, já saiu a habilitação e, com isso, já temos R$ 78,7 milhões para serem executados.
portuguese 9453	Como as empresas justificariam seus preços comparados com os nossos?
portuguese 9454	Além de contribuir para gerar estímulos à recuperação da vida do rio Tietê.
portuguese 9455	No início de seu mandato, o prefeito Mário Heins falou que sua proposta era implantar novos loteamentos industriais, com o objetivo de gerar emprego e renda ao município.
portuguese 9456	Me preocupo muito com a possibilidade de haver ainda mais ingerências na SEMA, mas do que há, no momento, e não são poucas, como essa Cambada de Político Infame - CPI.
portuguese 9457	De acordo com Michelle, a alimentação era de "embrulhar o estômago".
portuguese 9458	Neste sair do Pai e voltar ao Pai (cf.
portuguese 9459	Outras pessoas da comunidade são mencionadas por ele.
portuguese 9460	52Então Daniel chamou o primeiro e disse-lhe: Velho perverso!
portuguese 9461	2008 10h44 Conteúdo: "CC não pode pegar vaga de concursado" Primeiro deve haver a homologação dos concursos.
portuguese 9462	Não brinque com a sorte no que se refere a dinheiro.
portuguese 9463	Nesse caso, que nome o partido tem para oferecer?
portuguese 9464	Para a dona do cartão, que pediu para não ser identificada, a atitude do rapaz foi um gesto nobre.
portuguese 9465	Diógenes invadiu a área e foi bloqueado no momento do chute que daria o segundo gol ao time de Farroupilha.
portuguese 9466	Mas o pior ainda estava por acontecer..
portuguese 9467	O mais importante indicador de tendência de Frankfurt (DAX) registrou ligeiro ganho de 0,06%.
portuguese 9468	Encontraram o pai trêmulo.
portuguese 9469	Um clube como o Sporting, por exemplo, passou uma fase bastante negativa porque depois de ser campeão em 1999-2000 optou por contratar jogadores de indiscutível qualidade, a "custo zero" mas, quase todos em final de carreira.
portuguese 9470	Em 1994, quando Collor foi absolvido pelo STF, o petista disse: “Como cidadão brasileiro que tanto lutou para fazer a ética prevalecer na política, estou frustrado, possivelmente como milhões de brasileiros.
portuguese 9471	“O professor precisa ter cuidado para ensinar, mas isso gera uma estafa em sua vida”, diz.
portuguese 9472	“Sou apaixonada por dança, pode ser sertanejo, country, pagode e até ballet”.
portuguese 9473	Mas a demora para pintar tanta gente provocou sono e preguiça, o que levou o velho a sentenciar: – Vocês são muito preguiçosos, agora serão passarinhos, morcegos, porcos e borboletas.
portuguese 9474	Estamos unidos até que uma nova frase nos separe.
portuguese 9475	Vale lembrar que o distrital nunca convocou nenhuma reunião no Conselho, mesmo sendo presidente.
portuguese 9476	Tenho medo da guerra porque é uma forma muito absurda de tratar o planeta e todos seus seres vivos.
portuguese 9477	Continuas com as palas como os BURROS.
portuguese 9478	Eu viajo muito e não faço campanha.
portuguese 9479	Mas pelo menos o fato de ter provocado o debate pode ser positivo para mostrar que uma reforma ampla é necessária para chacoalhar a vida dos políticos.
portuguese 9480	"Ele é um grande profissional.
portuguese 9481	O culpado numero um pelo meu assassinato com certeza é edson neves, pois alguns de seus cupinchas já me ligaram fazendo ameaças.
portuguese 9482	Aliás, no último ensaio esse acordo foi quebrado.
portuguese 9483	É uma lembrança que, certamente, será bem recebida pelo público, que, de ordinário, adora as novidades.
portuguese 9484	Amanhã quando retornar de viagem promete fazer o mesmo com outros jogadores e vai fazer proposta para alguns ficarem no clube.
portuguese 9485	Segundo Marina, Leal é um empresário que discutia e se preocupava com a sustentabilidade quando o tema ainda não era moda.
portuguese 9486	Das 2 mil doses recebidas ontem pela regional, todas foram distribuídas, no mesmo dia, para os municípios de Região Carbonífera.
portuguese 9487	O governo tentou faturar com a auto-suficiência em petróleo e com o sucesso dos carros bicombustíveis.
portuguese 9488	Muitas das vezes, leva-se mais de quatro dias para que se possa encontrar um Prefeito.
portuguese 9489	Os dois verbos não são sinônimos.
portuguese 9490	O nível técnico do confronto não era dos melhores e as duas equipes seguravam a posse no meio de campo.
portuguese 9491	Segundo: Apenas 19 palavras, de todo texto, foram ditas pela entrevistada, sendo o resto ACHOLOGIA do(a) repórter.
portuguese 9492	Enquanto isto não acontece, penamos em filas intermináveis.
portuguese 9493	A média mensal de internações de pacientes segurados pelo IPE em 2001 foi de 21 casos, contra 19 registrados no ano passado.
portuguese 9494	No total, foram cadastradas 686 cidadãs, sendo realizados 605 exames citopatológicos, 338 clínicos de mama e 200 testes rápidos de HIV.
portuguese 9495	As taxas custam R$ 45 (área de suporte), R$ 65 (atividades intelectuais) e R$ 80 (atividades gerenciais).
portuguese 9496	O senhor continua atende a população com esse serviço?
portuguese 9497	Quando o treino começa, fico surpreso com a presença de cerca de 30 pessoas que estão nas arquibancadas do Gilbertão para tietar os ídolos.
portuguese 9498	É impossível que ao transportar esta quantidade de passageiros sem ter problemas.
portuguese 9499	Mas isso exige uma série de cuidados para que realizem aceiros antes de qualquer queimada para se adotar critérios, como horário e épocas do ano.
portuguese 9500	Ricardo pergunta o que o filho quer e Rodrigo revela que já sabe de tudo, inclusive que o pai mantinha Vera em cárcere privado.
portuguese 9501	Os policiais, aliás, estão colaborando com o controle dos irregulares desde o último dia 2, quando, de acordo com Cláudia, passaram a exercer a função dos guardas municipais.
portuguese 9502	Neste caso precisamos de saber separar o trigo do joio e se a política norte-americana é criticável, o certo é que a mentalidade de um presidente do Irão também não é nada que se recomende.
portuguese 9503	Celebre nesse Natal seu amor a Cristo e ame a sua missão!
portuguese 9504	São pessoas, claro, bastante diferentes de mim – e talvez seja isso que as torna tão fascinantes.
portuguese 9505	O convênio que deverá ser firmado com o Governo do Estado, por meio da Secretaria de Planejamento, terá o benefício de receber recursos financeiros sem a obrigatoriedade de ressarci-los aos cofres do Governo, pois será a título de fundo perdido.
portuguese 9506	A Sadia – responsável pelo desempenho – apresentou um crescimento de 100,52% entre janeiro e agosto de 2008, comparado com igual período do ano passado.
portuguese 9507	Suas vidas são separadas e “isoladas” da sociedade.
portuguese 9508	Fica meu protesto a respeito deste canal de opinião do leitor, que desde o dia 20 tenho escrito e nada é publicado, deveria pelo menos nos notificar a respeito do porque, já que o Midiamax tem meu email, mas vou tentar mais uma vez.
portuguese 9509	Muito bom ter a prova que alguém se lembrou de você numa viagem, por exemplo.
portuguese 9510	Com a grande sequência de caminhadas, carregando dez litros, a dona-de-casa Apolônia Martins reclama: "Já começam a doer minha coluna e meus braços.
portuguese 9511	Para os demistas, a vaga de vice sempre foi estrategicamente guardada ao PMDB.
portuguese 9512	Laura pergunta a Bruna se ela ama mesmo Rogério.
portuguese 9513	Eu tenho a impressão de que, com a eleição de oito governadores, senadores e deputados, teremos uma melhor distribuição deste poder.
portuguese 9514	Nunca fizeram nada de errado.
portuguese 9515	" Para avaliar a concessão de crédito, Leite sugere que os bancos contratem funcionários com experiência em varejo.
portuguese 9516	Pela primeira vez nesta edição da festa (um desfile noturno estava programado para ocorrer na abertura do evento, mas foi transferido devido ao mau tempo), as alegorias passarão na parte da noite pela rua Borges de Medeiros.
portuguese 9517	Sou presidente do PSL e vou montar um grupo para resgatar o poder.
portuguese 9518	Dormir de bruços, mesmo sem travesseiro, como regra geral, não é bom para a coluna.
portuguese 9519	Estamos em um surto epidemiológico.
portuguese 9520	Quem sabe a justiça faz um pente fino nestas empresas e descobre quanto foram destinados para a campanha política do PT e dos partidos que dão sustentação ao governo do Lula.
portuguese 9521	De onde viria tanta água para dar sustentação à tão ousado projeto?
portuguese 9522	Segundo dados da Associação Nacional dos Fabricantes de Veículos Automotores (Anfavea), cerca de 70% das vendas de novos contam com um veículo usado na negociação.
portuguese 9523	“Tem que pagar, sim, para que o servidor possa se empenhar e se desdobrar.
portuguese 9524	Nos próximos dias, o promotor e outros colegas analisarão o material apreendido em busca de documentos que sirvam para fundamentar o pedido de impeachment do prefeito.
portuguese 9525	De Caruaru, muitos agentes de viagem compareceram, entre eles Maria do Carmo Rosal, Girlane Bione, Vivyan Maciel, Daniel e Dulce Gomes.
portuguese 9526	O primeiro golpe veio com a revelação, pela revista Veja, de gravações clandestinas nas quais um grupo de deputados da Bahia revelava ter recebido vantagens para trocar o PFL pelo PMDB.
portuguese 9527	Continuo usando minhas relações, aqui e no Exterior, para atrair investimentos no país.
portuguese 9528	No banco de reservas do rival, estará o amigo e um dos que o ensinaram a lidar com a carreira de treinador, Luiz Felipe Scolari.
portuguese 9529	Tiririca, o campeão de votos no Estado -foi escolhido por mais de 1,3 milhão de pessoas-, obteve 122 votos nas penitenciárias paulistas.
portuguese 9530	CB - No começo do dia, sai com três pessoas atrás de água, mas a situação e muito tensa.
portuguese 9531	Se a pessoa consegue caminhar e conversar, está muito leve.
portuguese 9532	Na época, a maioria (59%) era parda, 18% negras e 17% brancas.
portuguese 9533	Mas o sucesso da casa, que está obviamente associado à qualidade da carne, deve muito também às mãos preciosas da cozinheira.
portuguese 9534	Michael esteve à frente da mudança de atitude dos artistas afro-americanos.
portuguese 9535	Lembram-se do Pratas a fugir a sete pés de uma equipa do porco?
portuguese 9536	"O carimbo da faculdade também é importante.
portuguese 9537	Consiste também, no processo de desenvolvimento, permitindo-lhes acesso às oportunidades a partir do engajamento da sociedade civil e entidades que venham adotar em suas políticas de serviço e trabalho, a relação social de apoio à educação.
portuguese 9538	São três pontos conquistados neste domingo e um ponto conquistado no empate com o Flamengo-PI (0×0), em São Luís.
portuguese 9539	Carlos Condeço · Treinador Adjunto do Rio Ave União Lamas - Naval Santa Maria de Lamas receberá a comitiva navalista na próxima jornada.
portuguese 9540	Visite, entre - sem bater - e comente.
portuguese 9541	Durante a graduação, manteve um emprego.
portuguese 9542	Ela disse que a empresa dona dos vagões já foi multada várias vezes.
portuguese 9543	No final do dia, todos saíram ganhando, com exceção do FGC.
portuguese 9544	Saí da Casa São José uma ou duas vezes, quando o grego Demetrio Haralampidis (o Mitcho) contratava meus préstimos de faxineiro na loja ao lado, a Casa União.
portuguese 9545	Abandonada pela prefeitura, conta com a colaboração de moradores para se manter limpa.
portuguese 9546	Hoje em dia não tem nada disso.
portuguese 9547	Sempre o apoiei.
portuguese 9548	Uma fêmea de chimpanzé que participou do estudo e tinha mais de 30 anos também não teve um desempenho tão bom quanto o dos jovens.
portuguese 9549	Expandir Reduzir +comentar alex henrique de barros em 08.12.
portuguese 9550	Ele chega para disputar uma vaga com Fábio Ferreira no banco, já que Carlão, que atuava como zagueiro, volante e lateral-esquerdo, foi negociado com o Sochaux (FRA).
portuguese 9551	Esses não têm direito ao benefício", falou, acrescentando que as cestas básicas que estão sendo distribuídas também não cobrem essas despesas.
portuguese 9552	“Mas a maior dificuldade foi explicar a minha filha de 8 anos por que a amiguinha dela morreu.
portuguese 9553	A primeira razão é jogar pela honra de ser um clube grande, que deve sempre entrar para ganhar.
portuguese 9554	Vale lembrar que o Cercap pertence aos donos da firma FDL, que recentemente teve rescindido contrato com o Detran por decisão judicial.
portuguese 9555	Participaram do jogo os atletas Douglas, Edson, Felipe Piovezan, Felipe S., Felipe F., Jean, João, Guilherme, José, Rodrigo e Vinícius.
portuguese 9556	Até o som do click do batom fechando passou por vários testes.
portuguese 9557	Durante a solenidade de abertura, o secretário de Segurança Pública de Santa Catarina, Ronaldo José Benedet, fez um pronunciamento a respeito da formação e da disciplina das crianças e adolescentes.
portuguese 9558	Os fregueses e os vendedores estão perdendo o direito de trocar", afirma.
portuguese 9559	De um ponto de vista, o homem é um ser empírico e seus problemas, por serem os problemas concretos de um ser empírico, são também empíricos.
portuguese 9560	O jornal de Friburgo recebeu uma denúncia anônima informando que um dos acusados da morte do servidor municipal é morador do Buraco do Lacerda, no Jacaré.
portuguese 9561	Tem movimento econômico positivo ou negativo dando prejuízo ou não ao município?
portuguese 9562	Procure por promoções nas coisas que você precisa, mas evite comprar itens que estão com desconto, mas você não precisa; é uma velha armadilha para acabar com qualquer orçamento.
portuguese 9563	Este ano, segundo o assessor de imprensa do departamento, Rubens Fornasari Júnior, a situação no Município é melhor do que a do ano passado.
portuguese 9564	Então se fazem um conjunto de engenharias financeiras, todas dispendiosas tanto nos estudos como em todo o processo como é que estamos prestes a inaugurar o edifício e continuamos sem uma solução para o caso?
portuguese 9565	Ou seja: cada time deve levar quatro unidades quando for o mandante.
portuguese 9566	Na volta para o segundo tempo, uma situação inusitada.
portuguese 9567	Masfica seu exemplo.
portuguese 9568	A história até que é bem diferente, mas o argumento poderia ser o mesmo.
portuguese 9569	"Sábios são aqueles que partem sem ter ideia do quanto não sabem" Re: Não se esqueçam da OTA 3 anos, 8 meses passados #6917 Sinceramente portugal e um exemplo.
portuguese 9570	“Os dois políticos bem sabiam que arriscavam a vida, pois já haviam sido explicitamente ameaçados de morte.
portuguese 9571	Nesse papel, as telecomunicações são uma variável crucial.
portuguese 9572	Expandir Reduzir +comentar Marco Proença em 13.10.
portuguese 9573	Os joelhos desarticulavam-se a cada passo arrastando chumbo pelos pés.
portuguese 9574	Folia nas Ilhas - Uma grande estrutura será montada nas ilhas de Maré, Bom Jesus dos Passos e dos Frades para garantir segurança e alegria a essas comunidades com orquestras e bandas de percussão.
portuguese 9575	59 Comentários para “Do congresso” Neiva Angela da Cruz: 8 agosto, 2010 as 8:19 pm creio que quando intervimos estamos desviando o curso natural dos acontecimentos.
portuguese 9576	Além disso, o tucano garantiu que muitas das obras feitas durante sua gestão só foram possíveis devido às ações da primeira-dama, que é arquiteta.
portuguese 9577	31 janeiro, 2009 as 10:35 pm Nem precisava do seu texto pra me deixar com mais vontade ainda de ver o filme Zeca!
portuguese 9578	Confira os dados abaixo: Como o sr (a) avalia o mandato do atual governador do Estado até o momento?
portuguese 9579	Decididas a se divertir, mas nada dispostas a somar as calorias do álcool com as dos alimentos, elas simplesmente trocam a comida por uma dose (ou várias) de bebida alcoólica, acreditando que, assim, não vão engordar.
portuguese 9580	Houve um momento em que Edson Luís, depois de esquadrinhar o local, bater nas grades, ver presos, ouvir gritos, voltou-se para Amelinha: - Mãe, você é bandida?
portuguese 9581	Tente aprender, aprendendo a tentar.
portuguese 9582	Em 2006, chegava a 40 milhões, num país de quase 200 milhões.
portuguese 9583	Guarda consigo o segredo de ter sido casado com Milady, a pérfida espiã a serviço do cardeal Richelieu; Aramis, este é astuto e generoso, que vê a vida como um jogo divertido, composto de amor, ação e preces.
portuguese 9584	A extracção da vesícula numa serpente é uma operação executada em menos de dez segundos.
portuguese 9585	Ele repete muitas vezes que Deus é unidade, e que só em Deus ela se encontra no estado puro e originário.
portuguese 9586	No início da sessão, o presidente da Assembleia, Robinson Faria (PMN), anunciou que, conforme entendimento de todos os líderes e demais parlamentares, houve a inversão de pauta.
portuguese 9587	No primeiro ano após o término da carência, paga, mensalmente, o mesmo valor que vinha pagando à faculdade enquanto estudava.
portuguese 9588	O jovem empreendedor vendeu as lojas e mudou-se para Ponta Grossa (PR).
portuguese 9589	Nas mexidas do jogo de domingo, o Fortaleza perdeu.
portuguese 9590	Continuemos então a dialogar com os irmãos muçulmanos a fim de construir um mundo melhor, reconciliado, pacífico e justo.
portuguese 9591	O primeiro é do PT – que antes condenou o imposto ; o segundo é do PSDB, que criou a “facada” e que não aceita sua volta.
portuguese 9592	Depois de 11 meses de luta, o grupo guerrilheiro estava reduzido a 17 homens, dos 38 originais.
portuguese 9593	O Instituto apelou, afirmando preliminarmente que era impossível a concessão da pensão integral.
portuguese 9594	Egnaldo responde: "Vou para Itiquira com Robson buscar o dinheiro".
portuguese 9595	" Confira, no link abaixo, as imagens da agressão: Clique aqui e confira o vídeo da confusão (Assista ao vídeo no site Futebol Interior.
portuguese 9596	Ninguém denunciava ninguém..
portuguese 9597	Por que hoje é tão complexa a vida moderna, com tão graves e difíceis conflitos, que é absolutamente possível os juízes conseguirem saber tudo ao mesmo tempo, só há uma solução para isso, a especialização.
portuguese 9598	Os novos cursos vão começar no dia 17 de maio.
portuguese 9599	Bem, o pobre ultrapassado pensador sera lembrado como um rancoroso lider que enveredou para a direita no fim se sua vida.
portuguese 9600	A arte do jovem se explica quando ele conta que já fazia artesanato aos 11 anos.
portuguese 9601	Enquanto isso, as tendências em níveis regionais variam muito.
portuguese 9602	Há boas chances de solucionar essas questões.
portuguese 9603	A segunda terminou embargada por uma ação impetrada pelo Sindicato dos Auditores Tributários de Sergipe (Sindat).
portuguese 9604	Isso fez que o Zé Carlos lembrasse que ele também tinha que levar um.
portuguese 9605	O senador que prometeu que ela iria revolucionar Natal, agora prefere elogiar Lula.
portuguese 9606	17 março, 2009 as 4:56 pm Viva um dia de cada vez, seja feliz e viva seus momentos de alegrias, pois só é feliz aq 6 março, 2009 as 3:57 pm Simplesmente o Paulo Coelho é d+.
portuguese 9607	Um dos veículos apareceu no estacionamento com as rodas originais substituídas por outras de estilo mais esportivo.
portuguese 9608	Como Jean acabara de marcar um gol contra, vestiu a carapuça e respondeu com amargura.
portuguese 9609	A bola passou longe, mas o lance foi muito bonito.
portuguese 9610	Melhor para Fernando Alonso, que, correndo em casa, chegou em segundo e embolou a briga pela liderança do campeonato.
portuguese 9611	Garanto que só de falar nesse assunto já veio em mente aquela pessoa que vive pentelhando o seu dia a dia.
portuguese 9612	Fulana torceu o dedo e agora está dodói.
portuguese 9613	A primeira equipe trabalha da Rua Xavantes, Bairro Tupi, em direção ao Campo da Aviação; o outro grupo da rotatória localizada no Bairro Aviação até a Rua Oswaldo Sampaio, sentido Tupi.
portuguese 9614	Deve ser mesmo um problema geográfico.
portuguese 9615	Marcelo fala para Kahlyne Abdelnor: vc e natural de belem mesmo?
portuguese 9616	", disse o francês em depoimento publicado em Écrits et propos sur l’art, Éditions Hermann, Paris, 1972.
portuguese 9617	De acordo com a Defesa Civil, ao menos três casas da rua Campo de Marte foram atingidas pelo volume de terra que derrubou ainda o muro de arrimo construído pela empreiteira.
portuguese 9618	Quando apareceu aquela grana toda no Maranhão (lembram, filhinhos?
portuguese 9619	Se não, amargará o desleixo do abandonado assumido, assistindo as atenções e preocupações serem atribuídas aos irmãos das pontas.
portuguese 9620	Seria se acertado, o mais sublime.
portuguese 9621	A segunda é que, se o governo for com muita sede ao pote, pode provocar um acidente de grandes proporções e colocar em risco não só a biodiversidade marinha, mas a vida dos que dependem dos recursos do mar.
portuguese 9622	Mas com tudo as minhas condulencias para o "compatriota" e desejo que o seu filho (pelo o dano psycologo causado pelo suicidio)clama-se a vida e acredite que a possibilidades de ser feliz.
portuguese 9623	O comunicado da Superintendência Regional da Caixa Econômica Federal em Campinas revela ainda que o termo de adesão assinado pelo prefeito Mário Heins em 27 de abril do ano passado não tem prazo de vencimento.
portuguese 9624	Este ano a dívida norte-americana atingiu 94% do PIB, e continua subindo.
portuguese 9625	Atriz recebeu alta após se recuperar de uma isquemia cerebral.
portuguese 9626	Que não é exatamente isolado.
portuguese 9627	Espólios de Hartung: caos na saúde, homicídios em alta, presídios lotados e escolas ruindo Foto capa: Thiago Guimarães/Secom Bastaram menos de 100 dias do novo governo para o conto da “casa arrumada” ir por água abaixo.
portuguese 9628	Machado, que é editor multimídia do Estado de S. Paulo.
portuguese 9629	Para encarar o mauricinho, tem ido aos bares cariocas com os amigos para observar como meninos e meninas se comportam a mesa.
portuguese 9630	Só perdeu apoios.
portuguese 9631	A vereadora Léa Silva, com o apoio do PFL e do senador Efraim Morais, também deve entrar na briga.
portuguese 9632	Quando se apresenta cheio de humildade, de compreensão e vontade de aprender, resplandece e brilha!
portuguese 9633	Quércia, hoje, é um dos aliados de Kassab – atraído pelos tucanos do grupo de Serra.
portuguese 9634	Eu estou super feliz e me sinto sortuda", afirma a dona de casa, Eva Maria de Araújo.
portuguese 9635	O relator, Índio da Costa (DEM-RJ), entendeu que apenas políticos com condenações por órgãos colegiados deveriam ser impedidos de se candidatar.
portuguese 9636	CL - Estou pronto para fazer tudo e muito mais e também estou pronto para não fazer nada, que é um direito que me cabe.
portuguese 9637	É com as regras do Direito Imobiliário e do Direito Registral Imobiliário, compostas de princípios, leis, decretos, resoluções, provimentos, portarias, etc. que trabalha o Cartório de Registro de Imóveis.
portuguese 9638	Que sirvam de alerta aos frequentadores de restaurantes, lojas, aeroportos.
portuguese 9639	Por meio de uma denúncia anônima, o possível crime foi descoberto, no Jardim das Orquídeas.
portuguese 9640	Peça voto para ele.
portuguese 9641	Isso justifica plenamente como, no final, o filho de Hassam – Sohab, atinge Assef no olho com a bola – cumprindo a ameaça feita pelo pai; muito mais legal.
portuguese 9642	De acordo com o empresário, o novo shopping é mais um marco no plano de expansão da empresa e deve ficar pronto em um prazo de 18 meses após a aprovação da documentação pela Prefeitura de Rio Preto e concessão das licenças necessárias à construção.
portuguese 9643	As ações deverão ser detalhadas e iniciadas nos próximos dias.
portuguese 9644	Sendo o desemprego de natureza estrutural e representando hoje apenas valores mínimos, e praticamente estáveis em valores absolutos, o recurso à mão-de-obra importada é fundamental.
portuguese 9645	Maria Paula encontra Claudius com Renato no quarto.
portuguese 9646	Já as classes especiais, cinco colégios da prefeitura atendem 90 estudantes.
portuguese 9647	Derrubado o imposto do cheque, Agripino e Virgílio liberaram suas bancadas para votar como bem entendessem os artigos que diziam respeito a DRU.
portuguese 9648	O aumento dos ataques sexuais é uma realidade nos acampamentos de refugiados, sem luz durante a noite e pouco protegidos.
portuguese 9649	Dois minutos depois, Airton invadiu a área e chutou forte, levando Magrão a uma bela defesa.
portuguese 9650	Mas ressaltou “ainda dá tempo de se frear os gastos ”.
portuguese 9651	Eu sempre olhei para essa proposta como tendo racionalidade económica e tinha que ser apreciada e analisada nessa base e não para resolver um problema de clivagem entre accionistas.
portuguese 9652	Foi assim com o império romano.
portuguese 9653	“No campo deles nós perdemos, mas aqui em casa o nosso campo nos favorece”, disse João Braz, o diretor da equipe barbarense.
portuguese 9654	Diz mais: “todo ser humano tem deveres para com a comunidade no qual o livre e pleno desenvolvimento de sua personalidade é possível.
portuguese 9655	O primeiro bairro a ser visitado foi a Estrada da Raiz (zona norte da cidade), onde caiu um pontilhão.
portuguese 9656	Por exemplo: o tema do aborto: aqui produz mortes.
portuguese 9657	Então você está louca para comer um sashimi.
portuguese 9658	Com casa lotada, as apresentações das candidatas e candidatos em trajes esporte, banho e noite agradaram ao público presente.
portuguese 9659	Para Ademir Cezari, do Km 4, interior de Francisco Beltrão, não há tanta poeira para colher, e isso tem ajudado.
portuguese 9660	Todo grupo sempre tem um líder e cada líder deveria ter caráter e respeitar a causas de seus liderados.
portuguese 9661	Touro invade arquibancada e fere dezenas na Espanha.
portuguese 9662	A criminalidade só diminuirá com o acesso aos jovens às oportunidades de emprego.
portuguese 9663	Habilidoso nas questões burocráticas.
portuguese 9664	Nossa equipe já está elaborando um projeto para apresentar junto ao ministério, à Lei Rouanet.
portuguese 9665	Na primeira, aos 32, ele passou por Godri e cruzou na medida para Dagoberto escorar para fora.
portuguese 9666	Qual a razão que os governos têm para esquecer o nome de João Pessoa?
portuguese 9667	É essa, aliás, uma vantagem que se denota na capacidade de recepção de visitantes no sector dos serviços, especialmente dos provenientes da China, da Malásia e da Europa e América.
portuguese 9668	As testemunhas afirmaram que a vítima não conseguiu sair do rio e que seu corpo desapareceu no local.
portuguese 9669	Odilon, não existe divisão entre Delegados novos e velhos.
portuguese 9670	Dorina se cerca de pessoas nas quais confia, quando o assunto é beleza.
portuguese 9671	Estava sendo negociada a transferência de tecnologia dos aviões Brasília e Ipanema (usado em atividades agrícolas).
portuguese 9672	Este crime com um réu confesso é inadimissível o assassino estar atrás das grades.
portuguese 9673	E se fosse ao cerne da questão: Dá prejuízo, PORQUÊ?
portuguese 9674	A dificuldade é enorme, enorme, enorme, enorme..
portuguese 9675	Segundo os envolvidos, foi uma resposta à pancadaria no futebol de campo, que remonta à Segundona em 2005.
portuguese 9676	Mário Camarão: Olá Idel, tudo bom?
portuguese 9677	Para esse ano, a meta é reduzir pela metade esse tempo.
portuguese 9678	Na Bolívia, nacionalizamos para que o povo tenha recursos e os Estados Unidos querem nacionalizar a dívida", disse Evo Morales.
portuguese 9679	” Chalabi, que exerceu como vice-ministro do Petróleo e reuniu-se com as companhias petrolíferas antes da invasão, descreveu este movimento como “um objetivo fundamental.
portuguese 9680	Se esse for o caso da sua empresa, tente mudar para uma função no mesmo nível da sua, por exemplo, mas que permita desenvolver novas habilidades.
portuguese 9681	Os desdobramentos do caso da prefeita vão se juntando a outras evidências de que o Brasil se cansou de acompanhar passivamente a ação do crime organizado.
portuguese 9682	Venha lutar para falar com responsabilidade e não jogar pedra que este telhado também vos pertence.
portuguese 9683	O que configurou o mensalão?
portuguese 9684	"Não é para gastar, é para mostrar ao mundo que temos condições e credibilidade para superar a crise", devolveu o brasileiro numa das duas passagens mais importantes do telefonema de 15 minutos.
portuguese 9685	Basta pensar nas leis relativas ao chamado "direito ao aborto", nas experiências realizadas com os embriões e na liberalização da eutanásia.
portuguese 9686	Os pais das crianças alugarem até uma van para que não perder nenhum momento do desfile.
portuguese 9687	Tentou justificar afirmando que "Maceió foi indicada a segunda cidade como destino turístico do Brasil.
portuguese 9688	Ficavam de conversa ao relento da tarde, terminando cedo, porque dormiam todos com as galinhas, não havia muito que se fazer à noite.
portuguese 9689	Os angolanos seguem os ensinamentos do Guia Imortal, nao obsoletas ideias savimbista.
portuguese 9690	Em um dos últimos lances do confronto, Rodriguinho mandou a bola na trave e desperdiçou a chance de ser o herói andreense.
portuguese 9691	Também estavam em dúvida entre custear o tratamento e investir num apartamento na praia.
portuguese 9692	2008 13h39 Conteúdo: "Tropa de Elite abre o listão" Não podemos esquecer que PSDB e DEM fizeram a campanha de 2004 fazendo parte da mesma chapa e entraram juntos na prefeitura.
portuguese 9693	O fato se repetiu com o estudante Camilo Carvalho.
portuguese 9694	A carreira de Clooney começou aos 18 anos de idade, quando ela passou a fazer parte da banda do cantor e saxofonista Tony Pastor.
portuguese 9695	O deputado Donald Fernandes concordou, mas deixou claro que a ação judicial não vai parar.
portuguese 9696	Eles passaram a trabalhar com treinamento e gerenciamento, explicou Vieira.
portuguese 9697	Além das funções constitucionais de vice, tenho esse trabalho já definido.
portuguese 9698	O correto é criarem uma nova melodia ou pagarem o que os autores da música querem, o que não é nada barato.
portuguese 9699	Armando_Solari_Almeida Registrado em: Aug 28, 2004 Localização: Nos mais remotos confins do Universo Enviada: Ter, 11 Jan 2005 8:23 pm Assunto: interessantes as tais retóricas de michel. sobre cracks..
portuguese 9700	O candidato do PMDB acha positivo porque a sociedade já conhece o candidato do PSDB, diferente do passado.
portuguese 9701	Por pouco não sai o gol do Galo em lance de sorte, aos 38. Galo domina a etapa final No intervalo, o técnico Emerson Leão decidiu fazer mais uma substituição: tirou Kléber e colocou Trípodi.
portuguese 9702	Enquanto juvenil esteve um ano ao serviço do clube, mantendo a partir daí um contacto com ex-companheiros, treinadores e directores dessa época.
portuguese 9703	Outro, para o Ministério da Saúde, era endereçado a Serra.
portuguese 9704	Devido a uma administração fiscal prudente, os encargos da dívida líquida do país são extremamente baixos.
portuguese 9705	As 17 foram criadas pelo ex-prefeito Carlos Stüpp (PSDB).
portuguese 9706	A idéia de justiça, no entanto, é algo muito pessoal.
portuguese 9707	Muitos acidentes no final de semana Um total de 10 acidentes com vítimas foram registrados em Santa Bárbara d' Oeste durante o final de semana.
portuguese 9708	Produzia de tudo um pouco.
portuguese 9709	422,41 estão sendo investidos pelo Governo de Sergipe para garantir o conforto dos 600 alunos da escola.
portuguese 9710	Tenhamos um pouco de bom senso!
portuguese 9711	Participaram oito seleções e Serra foi a grande campeã.
portuguese 9712	Quantas vezes os óculos forem substituídos, garanto que serão levados.
portuguese 9713	«Vemos isso como uma decisão preocupante e muito lamentável.
portuguese 9714	Por isso mesmo é um dos melhores de Almodóvar Carmen Maura e Penélope Cruz.
portuguese 9715	Barranquilla e Santa Marta são outros dois destinos também muito procurados no litoral noroeste.
portuguese 9716	P - O que é os portugueses têm que os leva a reagir lentamente aos problemas?
portuguese 9717	A Secretaria de Estado da Educação divulgou na última sexta-feira, 18 de abril, o número de aprovados no exame, que aconteceu no dia 2 de março deste ano.
portuguese 9718	Maria Lúcia diz a Mário que a situação dele pode piorar se ela também obrigá-lo a se casar com ela.
portuguese 9719	Segundo ele, essa queda refletiu, além da menor atividade econômica, as compensações de tributos - pagamento de imposto com crédito de outro tributo -, que ocorreram com maior peso nesse setor.
portuguese 9720	Sem citar nomes e investimento, ele diz que uma empresa do porte da John Deere está negociando a aquisição de uma área de cem hectares.
portuguese 9721	As negociações estão sendo feitas com a Rede Globo.
portuguese 9722	Por dois meses, os competidores mirins viveram isolados em uma casa na capital Indonésia, Jacarta.
portuguese 9723	Outras descobrem na internet.
portuguese 9724	• Blog de Josias de Souza Alckmin fará primeira pergunta no debate deste domingo Do Blog de Josias de Souza na Folha Online: O debate deste domingo, primeiro tête-à-tête entre Lula e Alckmin terá duração de duas horas e 15 minutos.
portuguese 9725	Se o príncipe for da opinião de que seu país pode sediar uma corrida, voltaremos ao Bahrein", declarou.
portuguese 9726	Bailes na Figueirense A Sociedade Filarmónica Figueirense promove, neste mês de Setembro, vários bailes.
portuguese 9727	Além disso, o LEC poderá iniciar o certame com o Estádio do Café recuperado, não tendo que sair da cidade para mandar o seu jogo da segunda rodada.
portuguese 9728	Investir em energias renováveis: grandes barragens, eólicas, marítimas e solares isso é que seria bom investimento.
portuguese 9729	A única coisa que notei logo que vi as fotos é que estava sem flecha no arco, depois fui ler os comentários.
portuguese 9730	Foi bom que nós assumimos e viramos uma situação que aparentemente era desfavorável, a nossa presença no Centro Administrativo.
portuguese 9731	O seu Hélio foi o primeiro presidente.
portuguese 9732	O que nós discutimos é que teria que ser um posicionamento institucional do partido, após diálogo com os deputados.
portuguese 9733	Existem pessoas com esse defeito em qualquer lugar do mundo.
portuguese 9734	Sobre isso, padre Peres afirma: "Vi casos com 30 migrantes morando em uma casa com um só banheiro.
portuguese 9735	Marquei minha ginecologista para a próxima semana.
portuguese 9736	7.106 É, realmente, apesar do investimento todo do governo quanto a segurança pública, ainda não se vê um cidade tão protegida.
portuguese 9737	Enquanto o jornalista assina e/ou é conhecido, e por isso paga o preço do que escreve, diz na rádio, ou apresenta na TV, o bloguista nem é conhecido nem assina.
portuguese 9738	Já a segunda etapa, será no quadrante Glaziou, que fez a arborização da praça.
portuguese 9739	O jovem Samuel descobre o amor.
portuguese 9740	Quando não falta às aulas e cobra dos alunos, é um caxias.
portuguese 9741	Ou seja, pelos que mereciam e pelos que nunca quiseram trabalhar.
portuguese 9742	Da roupa que escolhera à maneira como cumprimentou cada um dos jornalistas, parecia ter o desejo de transmitir simplicidade e disposição para o diálogo.
portuguese 9743	O evento começa às 21h, na quadra da Camisa Verde e Branco (Rua James Holland, 663, Barra Funda; tel.: 3392-4982).
portuguese 9744	2011 - 09:30 Meus caros, este promotor parece ser do estilo Afonso Gil, vamos ver no que vai dar.
portuguese 9745	O primeiro lance do CRB foi logo no primeiro minuto de jogo.
portuguese 9746	Os links estão no final desta Carta Aberta e gostaria que vocês lessem as reportagens, analisassem e refletissem melhor sobre tudo o que está acontecendo comigo.
portuguese 9747	O órgão já recebeu sete representações contra Tiririca e em todos os casos a opinião foi pelo arquivamento.
portuguese 9748	Toda unanimidade é burra.
portuguese 9749	A segunda temporada do Schaeffler Música segue até novembro, com os artistas Aulus Trio, Ramon Jaffé e Andreas Frolich, Catarina Domenici, Trio Arché, WienerKlavier Trio, Ensemble São Paulo e Eduardo Monteiro, Marco Tezza e Zarzuela El Niño Judio.
portuguese 9750	Na quinta-feira, durante a entrevista, o prefeito Zé Maria disse que está pagando à vista a área e deixando para que seu sucessor leve adiante.
portuguese 9751	Indústria fluminense cresce, amplia empregos e retoma nível pré-crise mundial As vendas reais da indústria fluminense se mantiveram estáveis em agosto, com elevação de apenas 0,1% em relação..
portuguese 9752	O professor Luiz Carlos Alves da Cruz, conhecido como Luiz Preto, foi assassinado na véspera das eleições para prefeito da cidade.
portuguese 9753	Com coragem e objetividade, a presidente Dilma concordou com a decisão do Banco Central que recolheu R$ 61 bilhões dos bancos na forma de depósito compulsório.
portuguese 9754	Tantos cidadãos competentes que existem no Paraná e você vem com essa.
portuguese 9755	G1 - O portal de noticias da globo Um grupo de demônios procurava entrar na alma de um homem santo que vivia perto do Cairo; já o haviam tentado com mulheres da Núbia, comidas do Egito, tesouros da Líbia, mas nada havia dado resultado.
portuguese 9756	Bonita porque o Brasil é de facto muito bonito, não só pel..
portuguese 9757	Daí surgiu o projecto de fazer disto um espaço para educação ambiental envolvendo parcerias do ICN, que esteve envolvido desde o início, a Quercus, o Instituto do Ambiente e, portanto, houve o empenho de vários parceiros para a criação do espaço.
portuguese 9758	Da-lhe vozão, campeão de tudo, publico, pontos, renda, vitorias, gols feitos, melhor defesa.
portuguese 9759	Também ao contrário dos primeiros, os imigrantes espanhóis, talvez devido ao seu número bem mais reduzido, não chegaram a estabelecer laços comunitários mais profundos dentro do município.
portuguese 9760	A proposta amplia a faixa - de 16 a 68 anos.
portuguese 9761	Imperdível também, na próxima quinta-feira, Democrata x Nacional de Nova Serrana, um dos concorrentes diretos do Jacaré a uma das vagas no Módulo II do Campeonato Mineiro 2011, às 19h30 na Arena do Jacaré.
portuguese 9762	Os dois conseguiram R$ 132,5 milhões de verbas federais para Mossoró.
portuguese 9763	Os imensos areais da turística costa holandesa são rematados por dunas em frente às marginais existentes entre Haia e Zandvoort (perto de Amesterdão).
portuguese 9764	'A Aracruz não está certificada.
portuguese 9765	O coordenador da equipa nacional admitiu que a prestação de Diana Guimarães, também afastada da final dos 50 metros costas (1.
portuguese 9766	Sandro Nowacki, de Porto Alegre, diz ter ficado decepcionado com a reportagem, "por não ter citado nenhuma vez o tipo de ioga que tem o maior número de escolas do Brasil".
portuguese 9767	O benefício não será cumulativo com outras promoções e convênios, e também não será aplicado ao valor dos serviços adicionais oferecidos em camarotes, áreas e cadeiras especiais.
portuguese 9768	Se os votos nulos não chegarem a 50%, a junta eleitoral deve proclamar como vencedor o segundo mais votado”, explica o ministro Eros Grau.
portuguese 9769	Barão instiga a ira de Pedro dizendo que Dante está impedindo que ele reconquiste Beatriz.
portuguese 9770	Artigo 32 - Falecimento da Pessoa Responsável Em caso de falecimento da pessoa responsável, a ação de indenização relativa aos danos será exercida contra os representantes legais de sua sucessão, dentro dos limites estabelecidos na presente Convenção.
portuguese 9771	Há no futebol rituais de vitória, de crença e de superstição.
portuguese 9772	75. Clique para ler a matéria Contrabando e descaminho Em Naviraí, no início da noite do dia 07 (sábado), foram apreendidas 2.025 unidades de mercador..
portuguese 9773	O tombamento é mais um reconhecimento da importancia de Nhá Chica, nao só para a cidade e para país, mas também para a comunidade católica nacional e internacional.
portuguese 9774	Criei coragem para enfrentar certas e certos tipos de pessoas.
portuguese 9775	De toda forma, a assessoria deste mesmo senador já preparou argumentos para o "day after".
portuguese 9776	Está aqui o fulcro de toda a oração: a oferta total e sem reservas da própria vida ao Pai, pelo Filho, no Espírito Santo" (Ut unum sint, 27).
portuguese 9777	Mesmo residindo em Porto Alegre, nesse mesmo período, Marcelinho, como é conhecido até hoje, formava, ao lado de outros jovens um bloco de carnavalesco conhecido como H-Romeu.
portuguese 9778	E como descobridor de um novo país o governo Lula criou um país com excelentes níveis de saúde, educação, segurança e livre de banqueiros e seus lucros exorbitantes e principalmente um país sem corrupção.
portuguese 9779	Paralelamente a isso, os governos precisam ressuscitar ações educativas e programas que tirem adolescentes e jovens da ociosidade, que combatam o desemprego e deem apoio para as famílias (e não se trata apenas de dar vale-alimentação).
portuguese 9780	É dessa complexidade, que nos deixa muitas vezes confusos, outras vezes transtornados, algumas vezes até desesperançados, que emerge um Brasil diferente de tudo o que imaginávamos há 30 anos.
portuguese 9781	Também me desfiz da pouca poesia de Ribamar, a quem chamam de Gullar.
portuguese 9782	Insistência - Desde 2006 Roberto Teixeira estaria tentando negociar, em vão, na direção dos Correios, o pagamento da suposta dívida à Transbrasil.
portuguese 9783	Cada módulo é lançado através dos ônibus espaciais, foguetes Proton ou Soyuz.
portuguese 9784	Quando eu vou para uma cidade fazer shows, dependendo da correira, eu faço o possível para ir visitar as rádios locais.
portuguese 9785	Este orador disse aos jovens estudantes do IPCA para não ficarem à espera das benesses do Estado.
portuguese 9786	A minha mãe tinha medo de me levar ao hospital, porque o aborto é crime e podíamos ser as duas presas.
portuguese 9787	Débora diz que vai dormir.
portuguese 9788	Muitas vieram do interior do país buscando vida melhor.
portuguese 9789	Não adianta nada lidar com Ali-Babá com se estivesse diante de Madre Teresa de Calcutá.
portuguese 9790	Caí na mão do fornecedor por duas décadas; vinte cigarros por dia, às vezes mais", revela, em seu site (www.
portuguese 9791	Município de Ponta Delgada Procedimento de Contratação Pública por Concurso Público para Execução da Empreitada de Construção do Troço do Arruamento de Ligação à Rua do Henriquenho, entre o Km 0+390.
portuguese 9792	Ontem as aulas na escola foram suspensas por tempo indeterminado.
portuguese 9793	As dúvidas são pequenas perto da série histórica que a gente tem, da consistência intra-geográfica e intergeográfica.
portuguese 9794	Clarice chega em casa e Cortez disfarça.
portuguese 9795	Mas, me diga uma coisa, com os elencos que ele teve(tirando o de 2003) o que ele poderia fazer?
portuguese 9796	Trata-se do sorteio do concurso 1140, que ocorre hoje, às 13h, (hora local) da Mega-Sena, que está oferecendo a premiação de R$ 120 milhões.
portuguese 9797	O governo tem que ouvir o povo para saber quais as prioridades que a população tem”, disparou.
portuguese 9798	Roberto Carlos deu uma entrada forte, por trás, no atacante João Arthur.
portuguese 9799	"A carga tributária cresce mais que o PIB, por causa da técnica de tributação do tributo calculado sobre ele mesmo e do efeito cascata vertical, e mesmo com a queda da CPMF, os tributos federais cresceram substancialmente", afirmou Amaral.
portuguese 9800	Ou será uma idiossincrasia nossa?
portuguese 9801	Oficializada em 1920, a Folia de Reis vem lutando para se manter.
portuguese 9802	O musical, que custou US$ 12 milhões, faz parte de uma onda de espetáculos desencadeada em 1999 pela chegada da empresa CIE, de origem mexicana, ao país.
portuguese 9803	Nasrallah não para de mencionar a iminência de uma agressão de Israel contra o Líbano.
portuguese 9804	Enfrentou diversas denúncias de corrupção, mas sempre se manteve intacto.
portuguese 9805	Fui no Dr Raphael Saibel.
portuguese 9806	Os ingressos antecipados e os camarotes estarão à venda no Posto Auto Parque e pelo telefone: 9984-2534.
portuguese 9807	Vivemos juntos há 11 anos e há 11 anos que ele me bate.
portuguese 9808	Em Itália, gosta-se da mulher “au naturel”.
portuguese 9809	O vereador não é vereador 24h por dia?
portuguese 9810	Isso até o príncipe Manvendra Singh Gohil, de 43 anos, anunciar que vem ao Brasil para participar da Parada Gay, em junho deste ano.
portuguese 9811	P - Estamos a falar dos novos pobres, mas a Cáritas continua apostada em responder a necessidades muito básicas da população.
portuguese 9812	É a poluição visual com a colocação desordenada de placas e painéis em logradouros e fachadas.
portuguese 9813	Jó é um grande exemplo para nós!
portuguese 9814	A morte a todos alcança.
portuguese 9815	Junior conta para Raissa o segredo sobre a investigação de Vilma.
portuguese 9816	Odiados porque ainda têm poder.
portuguese 9817	Boninho – O Dhomini é um cara que jogou de forma bacana.
portuguese 9818	Um deles, há poucos dias, levou o cofre no qual a família guardava as joias.
portuguese 9819	Susana Vieira, que desfilará pela Grande Rio, virá representando uma “musa inspiradora”.
portuguese 9820	O curso é intitulado:　"EXCELÊNCIA, Vendas e atendimento na era do conceito e da inovação", voltado para a capacitação dos nossos funcionários visando melhorar o atendimento neste final de ano.
portuguese 9821	Segunda-feira - Lavínia rejeita a ideia de fugir com Fernando.
portuguese 9822	Mas não se esqueça que isso traz responsabilidade maior.
portuguese 9823	Se desta vez não houve sofrimento, a festa compensou.
portuguese 9824	Kam's/Los Angeles E absurdo pedir a cabeça do "Mr" nessa fase de campeonato por seguintes razoes: (1) Falta pouco para irmos a Alemanha.
portuguese 9825	Se ele não for candidato ou se for e perder pela segunda vez, a fila andará e ele ficará para trás.
portuguese 9826	Foi isso, em resumo, que aconteceu com o PT?
portuguese 9827	Eu fiquei sentada onde eu estava.
portuguese 9828	Pelo menos o Jose Duarte está cá.
portuguese 9829	Tititi (Mirandópolis) Você talvez não entenda porque insistimos tanto para que se homenageasse a data da Emancipação Político Administrativa do município.
portuguese 9830	Sem a necessidade de análise ou interpretação.
portuguese 9831	Cláudio Drews Jr.: 4 fevereiro, 2010 as 9:23 pm Após ler o conto fiquei aqui pensando: e se o homem resolvesse pedir algo diretamente em benefício de seu amigo?
portuguese 9832	O médico Wanderlei Idiarte, trabalha há anos na rede pública de saúde.
portuguese 9833	E, claro, é um sucesso incrível.
portuguese 9834	E, pelo que vejo, o discernimento que a Sra. diz ter, se refere a um de FALSO valor.
portuguese 9835	Berti: Sim, quem não gostar que processe.
portuguese 9836	Assim, temos que nos contentar com “quebra-galhos”, algo bem ao gosto nacional.
portuguese 9837	Precisa também da estratégia e da infra-estrutura do Grupo Axé Moi.
portuguese 9838	Ontem, foi divulgado no site o resultado de 2009, em categorias que vão desde o melhor cartaz de blockbuster ao com melhor frase engaçada.
portuguese 9839	Quanto a Tarso Genro, não escondeu as divergências entre ambos, mas garantiu que apoia a sua candidatura.
portuguese 9840	A URSS, por ordem de Stálin vinha empenhada num gigantesco esforço de produção de blindados, tanto que, no dia da invasão, tinha 20 mil tanques fabricados (a Alemanha tinha 3 mil).
portuguese 9841	Dois minutos depois, o lance mais bonito do jogo: Fábio Baiano avançou pela direita, deu um "balãozinho" de "charles" em Sorin e Ricardinho evitou o chute a gol.
portuguese 9842	Expandir Reduzir +comentar Ricardo Baumhardt em 03.04.
portuguese 9843	A presidente da República visita, como turista, a bela capital do país, Praga.
portuguese 9844	Caiu, acusado de corrupção.
portuguese 9845	As festas continuaram durante duas décadas.
portuguese 9846	Mais dois joguinhos e quero ir embora logo”, insistiu.
portuguese 9847	À pergunta que está impressa no topo do twitter (“O que você está fazendo?
portuguese 9848	Quem não concorda SEMPRE com Lula é antidemocratico?
portuguese 9849	A inveja, a falta de compromisso com a identidade cultural de nossa gente faz o Brasil de hoje, muitas caras e nenhuma identidade.
portuguese 9850	E se não for correspondido, não se apoquente.
portuguese 9851	100 anos de puro faro criativo, de muita inspiração e tendências na arquitetura, computação, e principalmente, em um novo formato de entender o que é cinema.
portuguese 9852	Foi a Cosan que propôs o acordo à AGU.
portuguese 9853	Com nenhum ponto, a equipe está na lanterna do Grupo A. O Boavista aproveitou o mau monto do Vasco e abriu 2 a 0 no primeiro tempo com gols de Tony e Frontini.
portuguese 9854	O resultado fica melhor quando esses ternos são combinados com camisas claras.
portuguese 9855	Shoigu afirmou ainda que continua a busca por outros 60 mineiros e membros das equipes de salvamento que desceram às galerias da mina de Raspadskaia após a primeira explosão.
portuguese 9856	Os Meus Filmes da Vida – l.º volume – da Assírio e Alvim, publicado em Agosto de 2003.
portuguese 9857	O candidato natural do PT, Vladimir Palmeira, do histórico, não vai bem nas pesquisas.
portuguese 9858	A trapaça dos empresários portugueses só aposto na mão de obra barata, no lucro fácil e rápido.
portuguese 9859	Quando li sua materia, logo, veio aquela identificação,Meu Deus será se é só eu que entro em estado de completa felicidade ao ouvir uma musica nova de alguma banda ou artista que eu adimiro faz tempo?
portuguese 9860	Há sete anos a iniciativa acontece na cidade e desde a edição de julho de 2007, o projeto começou a abranger também os pequenos.
portuguese 9861	Primeiro cabe esclarecer que os catadores estão divididos em grupos: Coopersan, Arpes e outros.
portuguese 9862	Eu nao conhecia a capital,depois de 5 anos no exterior.
portuguese 9863	É um jogador de velocidade, que sempre foi artilheiro por onde passou.
portuguese 9864	Luiz de Paula merece congratulações pela biografia completa, pela caminhada de menino da beira do rio, de negociante, de congressista, de rotariano, de capitão de indústria, de menestrel.
portuguese 9865	Só em 2006, 1.063 pessoas foram mortas em supostos embates com a polícia fluminense.
portuguese 9866	Vidas Opostos - Record - 22h Daniela e Mofado têm uma longa e emocionada conversa sobre suas vidas.
portuguese 9867	", "Morrendo de saudade" e "Anjinho de luz".
portuguese 9868	Sou Antero e Blairo, mas acho q Taques e Yanai também seriam boas opções.
portuguese 9869	Esse gene estaria relacionado à transformação de nutrientes da gordura do leite importantes para o desenvolvimento do cérebro.
portuguese 9870	Difícil é controlar a larica diante de uma fornada quentinha de pão de queijo e tantas outras guloseimas nos botecos e restaurantes que pipocam pelo trajeto.
portuguese 9871	Ela deve acontecer do nível técnico para o tecnológico e depois um curso de extensão ou MBA.
portuguese 9872	Mais informações eu não conto.
portuguese 9873	“Deveriam ser 25 anos por cada uma delas”, disse.
portuguese 9874	Trata-se da administração de Silvio Berlusconi, que se porta como o defensor dos italianos – contra os imigrantes e, em particular, contra os ciganos.
portuguese 9875	Que eu não tinha nascido, mas estudei e dei aula até como economista.
portuguese 9876	A formação do litisconsórcio ativo facultativo tem lugar e momento processual adequado: na exordial, quando do ajuizamento da ação.
portuguese 9877	Entretanto é importantíssimo que haja mais ações quanto a repressão aos que fazem da droga meio de vida, e aos usuários a conscientização dos malefícios das drogas, desde o cigarro e álcool.
portuguese 9878	Preparei uma equipe e comecei a investir no projeto, muito dinheiro mesmo, sem obter retorno, mas sempre vendiam uns ingressinhos que davam uns trocadinhos para a gente.
portuguese 9879	Se, antes de dar mamadeira com chazinho, você dá para um bebê uma mamadeira com cachaça, seu organismo e seu psiquismo irá acostumar-se ao etanol, irá ficar dependente dele, e para o resto da vida.
portuguese 9880	Fundamento e DECIDO: Considerando a superveniente manifestação do INCRA às ff. 601-680, dou por prejudicada a argüição (ff.
portuguese 9881	Os Isqueiros são para acenderem uma velinha aquando da breve morte do corrupto Pinto da Costa.
portuguese 9882	Encerrando em time que está ganhando não se mexe. agora as conseguencias virão por 04 quatro anos.
portuguese 9883	Alguns lugares são quase que parada obrigatória para os turistas: os mercados de artesanato, a Praça de Armas, o Qoricancha, o Vale Sagrado.
portuguese 9884	A explicação dos moradores é que roubar pode custar a vida.
portuguese 9885	Antes da contenda, os sumotori usam o kesho mawashi, traje de caráter mais formal e elaborado, embora na Era Edo (1603 – 1868) constituísse a verdadeira roupa de combate.
portuguese 9886	O encontro com Cristo foi o ponto de chegada de um caminho trabalhoso, cheio de provas.
portuguese 9887	Secretário Edson Heller (representante do prefeito municipal Armando Roos).
portuguese 9888	A Segunda etapa do Sistema Adutor do Alto Oeste é alimentada pela Barragem de Pau dos Ferros, em Pau dos Ferros.
portuguese 9889	Pouco depois, o treinador foi questionado se não estava se esquecendo do Santos, que aparece apenas três pontos atrás do Colorado, e com um jogo a menos que a maioria.
portuguese 9890	Para Anderson Cavalcante, porém, a criatividade nunca foi amiga do prazo.
portuguese 9891	Segundo o departamento médico do Flamengo o atacante fraturou dois ossos do antebraço.
portuguese 9892	Dos postos de gasolina que visitamos, todos eles constavam com o mesmo valor.
portuguese 9893	O pai da Eloá não esta envolvido?
portuguese 9894	Infelizmente não vai ser possível cumprimentar um a um, mas espero que todos se sintam abraçados por mim.
portuguese 9895	Gilmar Dantas Mendes e José Daslu Serra.
portuguese 9896	A culpa seria de um pastel.
portuguese 9897	Com um material humano muito inferior, conseguiu fazer um jogo parelho.
portuguese 9898	Gustavo Fruet (PSDB) talvez largue um pouco na frente pelo respaldo de ter sido o deputado federal mais votado no Paraná em 2006.
portuguese 9899	O famoso místico Ibrahim Adham entrou certa vez no palácio do governante local.
portuguese 9900	Tudo indica que terá maior percepção do valor das coisas e do seu próprio valor também.
portuguese 9901	Queriam que Mangano saísse da cadeia já que estava muito doente.
portuguese 9902	Analise se não vale mais o perdão que o orgulho ferido.
portuguese 9903	Associação de ex-moradores retoma preparativos Após a Feira das Nações, a Associação dos Ex-Moradores da Usina Santa Bárbara retoma os preparativos para a festa organizada pelo grupo nas terras da antiga Usina Santa Bárbara.
portuguese 9904	A atitude também indica uma transferência de ônus da operação ao cliente.
portuguese 9905	Os perfis levantados são analisados pela fábrica e passam por uma auditoria de credenciamento, especialmente nos quesitos de treinamento técnico, ferramentas, instalações, aplicação de peças genuínas e qualidade no atendimento, entre outros.
portuguese 9906	É que tu lhe dás teu próprio sangue.
portuguese 9907	Nesta primeira Audiência geral de 2009, desejo formular a todos vós fervorosos bons votos para o novo ano que acaba de iniciar.
portuguese 9908	Marina foi aplaudida quando afirmou que não é fácil fazer a reforma tributária e criticou a maneira com que opositores tratam o assunto.
portuguese 9909	Eram cavalas grandes, brilhantes, ainda vivas, que enchiam as redes - mas que, não tendo valor comercial que justificasse levá-las à lota, ficavam dia após dia a apodrecer na areia, até à próxima praia-mar.
portuguese 9910	O montante destinado à área de energia do PAC 2 vai somar R$ 1,09 trilhão, o maior volume de recursos do programa.
portuguese 9911	Tem mais o meia Marcos Antônio, o zagueiro Ewerton..
portuguese 9912	Chávez também comparou o colega a Jesus Cristo por trazer boas notícias para a Venezuela.
portuguese 9913	O projeto do estádio está praticamente pronto.
portuguese 9914	DICA: Cuidado com os gastos hoje, pode ter prejuízos de difícil recuperação.
portuguese 9915	As casas de prostituição, todas elas tem menores, com documentação irregular e infelizmente envolve um problema social.
portuguese 9916	“Se não for possível, esperamos, ao menos, que boa parte da pavimentação esteja concluída até dezembro”, acrescentou Nívio Pinto.
portuguese 9917	"De que adianta fazer doações, se o filho dela não se alimenta?
portuguese 9918	Não querias também xila?
portuguese 9919	"A segunda fase para remoção e transferência dos rejeitos ainda está em estudo.
portuguese 9920	"Não tínhamos muito equipamento de segurança.
portuguese 9921	E foi minha mãe quem me ensinou a unir a família não só nas horas de folga, mas nas de batalha também.
portuguese 9922	O formato do torneio para o Rio 2016 ainda não foi anunciado, mas o fato da Federação Internacional de Basquete (Fiba) ter cancelado a vaga automática para o Reino Unido em 2012, já deixa o dirigente brasileiro apreensivo.
portuguese 9923	De qualquer modo, Rocha Vieira não se sente defraudado e prefere olhar para o futuro.
portuguese 9924	Esta, repleta de alegria, após uns goles, entornou devagarzinho o café na boca de Pereirinha, para que bebesse aos golinhos.
portuguese 9925	Kenia é filha de um radialista, que é repórter policial.
portuguese 9926	Certamente o promotor tem seus defeitos, mas também tem seus méritos.
portuguese 9927	Pretende, contudo, levá-la diretamente ao ministro Edison Lobão, que não teria comparecido à reunião por estar doente.
portuguese 9928	O efeito residual é fundamental para a eliminação total da praga e garantia contra a re-infestação pelos mosquitos.
portuguese 9929	E assim, o Nino não via a hora de chegar em Monte Belo e mostrar a novidade para sua mulher.
portuguese 9930	Desejo aqui dizer-lhe, já que penso falar com uma intermediária ou porta-voz do dito “escritor”, que jamais me convenci com respeito ao seu “protegido”, uma vez que estampada nos livros dele e também em seu rosto, a imagem da mediocridade.
portuguese 9931	Em nossas terras já se ouve a voz da rola.
portuguese 9932	Atualmente, o SBU soma 846.553 unidades, sem contar os 252.318 e-books.
portuguese 9933	Quando os outros partidos da oposição começarem também com as suas campanhas..
portuguese 9934	Na berlinda, aparece o prefeito da Serra, Sérgio Vidigal (PDT), principal aliado da agora ex-deputada Aparecida Denadai (PDT) que foi acusado de ser o braço político do bando.
portuguese 9935	Eu vivo da televisão e do rádio.
portuguese 9936	"Temos 45 associados, trabalhamos com mandioca, frutas, batata doce e banana prata", informou Elza.
portuguese 9937	Segundo a coordenadora do Núcleo de Meteorologia e Hidrologia de Goiás, Rosidalva Lopes, as chuvas devem cair em níveis significativos até segunda-feira.
portuguese 9938	A ponte de Jabuticabeira, em Jaguaruna, foi liberada no fim de semana.
portuguese 9939	Preparo um espaço especial?
portuguese 9940	Não nos dá tempo hábil para reflorestar.
portuguese 9941	IVC divulga acessos de websites que audita O Instituto Verificador de Circulação (IVC) publicou nesta segunda (17) o resultado da medição de acessos dos 39 websites brasileiros por ele auditado (clique e confira).
portuguese 9942	Todos os projetos do Bi Garcia são de interesse do povo e essa oposiçãozinha ridícula só quer aparecer.
portuguese 9943	Pelos cálculos do TSE, há 76 municípios brasileiros com mais de 200 mil eleitores.
portuguese 9944	Calça saruel, jeans skinny, camisa xadrez, camisetas tipo pólo ou em gola V. Malha flamê, tricoline, flanela e nylon também para os pequenos.
portuguese 9945	Durante o evento foi realizado um jantar de confraternização oferecido pela Federação dos Pescadores de Santa Catarina na Sociedade Amigos da Lagoa, onde aconteceram festividades e homenagens.
portuguese 9946	Em meio a discussões acaloradas, várias vezes apartadas pelo imperador e seus soldados, foram estabelecidos o primado da Igreja Romana sobre a cristandade, o dia da Páscoa e importantes dogmas doutrinários.
portuguese 9947	Tambem pudera a turma do PT aliar-se ao motossera de ouro vai afundar juntos.
portuguese 9948	O crime aconteceu quando ele descia do veículo, o mesmo utilizado por ele no ano passado, para fugir, quando atentou a tiros contra a vida da ex-namorada.
portuguese 9949	A expectativa da entidade para 2010 é de que o crescimento da receita fique em torno de 20% em relação ao ano passado.
portuguese 9950	A pesquisa de avaliação do governo mostrou um novo recorde.
portuguese 9951	O tesouro do estado controla os recursos e manobra no entendimento do próprio gestor”, avalia Furquim.
portuguese 9952	Para quem tem acesso a internet, há um Guia de Informações disponível pelo site: www.poupatempo.sp.gov.br. O ônibus de atendimento realiza a prestação de serviços até o dia 13 de dezembro, das 9h às 17h, de segunda a sábado.
portuguese 9953	A negociação também ocorre para 2010” – disse uma alta fonte política.
portuguese 9954	Um apoio à turma do PT ligada ao derrotado Abicalil?
portuguese 9955	É um convite personalístico, onde o convidado é reverenciado de forma visual.
portuguese 9956	Félix encontra com Carla e já vai querendo beijá-la.
portuguese 9957	As regras mais rígidas existiam, mas eles burlavam, davam um jeito.
portuguese 9958	É um campus com ensino profissionalizante e que pode ajudar muita gente, já que o ensino é gratuito”, afirmou.
portuguese 9959	Claro que não era líquida e certa, é da democracia.
portuguese 9960	«Não podemos confundir este aspecto apenas com o nível social e económico.
portuguese 9961	Hoje, ele é funcionário público e diz que recomeçou uma vida nova, mas que ainda não conseguiu recuperar metade do que tinha naquela época.
portuguese 9962	Anderlei Antonelli, prefeito de Criciúma.
portuguese 9963	A inscrição do candidato não selecionado para a isenção de taxa será de sua inteira responsabilidade, arcando este com o pagamento do valor da taxa no mesmo período de inscrição, constante no subitem 3.1.
portuguese 9964	E muitas outras coisas que não me retrata como uma fanática cega, assim como você me julga.
portuguese 9965	Quando o alistamento eleitoral for reaberto, no dia 7 de novembro, o eleitor residente fora do Brasil deve procurar a repartição consular ou missão diplomática do país em que residir, levando passaporte e comprovante de residência.
portuguese 9966	Aos poucos, ele foi falando sobre o que está por vir.
portuguese 9967	“É um desafio que, se encarado de uma maneira responsável, pode renovar a vontade dos professores pela sala de aula”.
portuguese 9968	"Para o sindicato, demonstra a preocupação da sociedade e da mídia com os servidores", avaliou Manoel.
portuguese 9969	Estamos propondo que a Capital faça, juntamente com os municípios da Região Metropolitana e com o governo do Estado, a discussão da região como um todo.
portuguese 9970	Ali está o Emanuel, o Criador que se fez criatura, envolvido em faixas e posto numa pobre manjedoura (cf.
portuguese 9971	Lutar pela saúde do planeta é um desafio de todos nós.
portuguese 9972	Centro de Formação Atlética no entorno do Ginásio Municipal de Esportes.
portuguese 9973	Os resultados ainda não foram publicados em uma revista científica.
portuguese 9974	Vai comendo, Raimundo..
portuguese 9975	A questão é que não é só PT e PMDB que não se bicam.
portuguese 9976	Em nome do Movimento de Irmãos da Paróquia Santo Antônio dos Anjos da Laguna, gostaria de agradecer a este conceituado jornal pela divulgação que fez da arrecadação coletiva de alimentos, promovida por este movimento, no último sábado.
portuguese 9977	São Paulo cresceu exatos 18,1%.
portuguese 9978	Pode ser que não atire para o mercado produtos de má qualidade, que alimentavam apenas a histeria de consumo de pessoas que nem sequer eram leitores.
portuguese 9979	O mais bonito é que moças e rapazes desempenham a função.
portuguese 9980	Quero dar então a nossos adversários a chance de ser coerentes agora.
portuguese 9981	Experimentei a pedido porque, inseguro sobre os meus talentos de prof.
portuguese 9982	Poderia causar alguma dor de cabeça, mas uma vez ali em cima, será um tipo diferente de maçada.
portuguese 9983	Falou que a Igreja não pode e não deve ser um tempo alienante e de alienados.
portuguese 9984	Agora o Presidente Lula quer dobrar essa quantidade.
portuguese 9985	Em entrevista coletiva após o jogo contra a Lusa, o treinador deixou claro que a volta do titular não é emergencial.
portuguese 9986	E que Deus os proteja das polêmicas inócuas, e abençoe nossa presidenta, ou presidente.
portuguese 9987	Todo mundo, gravadoras e artistas querem alguém que esteja em evidência com as próprias pernas, então não saberíamos responder de cara.
portuguese 9988	Só sabem abrir a boca para proibir.
portuguese 9989	Ele arriscou alguns trabalhos como ator.
portuguese 9990	Groisman estreou em 11 de dezembro com Ação, um curto programa sobre educação que vai ao ar nas manhãs de sábado.
portuguese 9991	O Vice Celio Matou duas pessoas, inclusive um na passagem do ano novo. o Titor em pouco tempó que ficou como vereador tomei conhecimento que só falava que éra o brabo e que tinha armas, desafiava todo mundo, e se diz homem de Deus.
portuguese 9992	O deus que respondesse com fogo esse era aclamado o verdadeiro Deus.
portuguese 9993	Com ele não teve diferença de grande e pequeno, teve sim, o trabalho profissional e idôneo.
portuguese 9994	Se diante do sofrimento deste mundo o protesto contra Deus é compreensível, a pretensão de a humanidade poder e dever fazer aquilo que nenhum Deus faz nem é capaz de fazer, é presunçosa e intrinsecamente não verdadeira.
portuguese 9995	Denuncie Até quando as autoridades permitirão tanta injustiça?
portuguese 9996	Alex Sti, em Campo Largo, o que adianta dar a cara pra vagabundo, se hoje ja fazem isso com os nóias e sem colete aprova de bala.
portuguese 9997	Ele também agradeceu às autoridades do Cremesp, que estão engajadas na orientação aos médicos.
portuguese 9998	O Inter colocou os nervos no lugar e tratou de valorizar a posse de bola.
portuguese 9999	Falta o confronto analítico.
portuguese 10000	Citou o número de campos que Arujá dispõe e reafirmou o compromisso da administração municipal de criar novas praças esportivas além de melhorar aquelas que já existem.
